id,LivArea,grade,Area_of_house(excluding_basement),Area_of_basement,number_of_bedrooms,YearBuilt,SalePrice
6762810145,3650,10,3370,280,5,1921,2380000
6762810635,2920,8,1910,1010,4,1909,1400000
6762810998,2910,8,2910,0,5,1939,1200000
6762812605,3310,9,3310,0,4,2001,838000
6762812919,2710,8,1880,830,3,1929,805000
6762813105,2600,9,1700,900,3,1951,790000
6762813157,3660,10,3660,0,5,2006,785000
6762813599,2240,8,1550,690,3,1923,750000
6762813600,2390,8,1440,950,3,1955,750000
6762814461,2200,7,1300,900,4,1920,698000
6762814787,2820,8,2820,0,5,1979,675000
6762815225,1820,7,1640,180,4,1945,650000
6762815461,1520,7,1520,0,4,1945,640000
6762815654,2710,9,2710,0,4,2000,630000
6762815737,1750,9,1470,280,3,2005,626000
6762815748,2820,9,2820,0,4,2014,625000
6762815749,2730,9,1560,1170,4,2007,625000
6762815986,2360,8,1360,1000,3,1948,615000
6762816059,2730,9,2730,0,4,1991,612500
6762816236,3240,10,3240,0,3,1995,604000
6762816633,2330,8,1970,360,3,1980,588500
6762817449,3310,8,3310,0,4,2012,555000
6762817570,1940,7,1140,800,4,1976,550000
6762817571,2910,8,2910,0,3,1979,550000
6762819227,2860,8,2190,670,4,2004,499950
6762819342,1600,8,1130,470,4,1959,495000
6762819448,2190,9,2190,0,4,1968,491500
6762819463,880,7,880,0,2,1938,490000
6762819732,2710,9,2710,0,4,1989,482000
6762820114,2210,8,1460,750,5,1976,470000
6762820382,1710,7,1710,0,3,1948,463000
6762820510,2680,8,2680,0,3,2013,459990
6762820718,2430,7,1570,860,3,1985,452500
6762821047,1270,8,1270,0,3,2001,445700
6762821205,2160,8,1080,1080,4,1966,440000
6762821206,800,7,800,0,2,1944,440000
6762821318,1770,8,1770,0,3,1990,439950
6762821390,1970,9,1970,0,3,1977,437500
6762821424,1770,8,1600,170,3,2007,436110
6762821444,1450,7,1450,0,4,1954,435000
6762821632,1920,7,1070,850,4,1954,430000
6762822054,2000,8,1000,1000,3,1963,420000
6762822175,1570,7,1570,0,3,1956,419000
6762822578,1930,8,1930,0,3,1996,407500
6762822721,1960,8,1650,310,3,1957,403000
6762822791,3630,9,2300,1330,4,1979,400000
6762823455,1320,8,1040,280,3,2008,385000
6762823582,1560,7,1560,0,4,1967,382500
6762824201,3110,8,3110,0,4,1997,367500
6762824245,1090,7,1090,0,3,1955,365000
6762825272,1930,8,1930,0,3,1966,342000
6762825549,1350,8,1350,0,2,1976,335000
6762825550,1580,7,1580,0,3,1978,335000
6762826461,1160,7,1160,0,3,1968,315000
6762826606,1340,7,1340,0,3,1955,313000
6762826811,850,7,850,0,2,1950,308500
6762827056,2540,7,2540,0,3,2006,300000
6762827347,1630,7,1280,350,2,2009,295000
6762827693,1850,7,1090,760,3,1992,287200
6762827749,2200,8,2200,0,4,1987,285000
6762827750,2090,8,1360,730,3,1987,285000
6762827836,1800,7,1800,0,3,1968,284000
6762828162,1180,6,1180,0,3,1983,275000
6762828790,1480,7,1480,0,4,1974,260000
6762828945,1370,7,1370,0,3,1987,257950
6762829578,1200,7,1200,0,3,1965,242500
6762829789,1210,6,1210,0,2,1949,235000
6762815750,2920,8,2920,0,4,2012,625000
6762817521,900,7,900,0,2,1944,553000
6762823736,1650,7,1130,520,3,1986,379880
6762826674,1010,6,1010,0,3,1973,310000
6762813188,2850,10,1990,860,3,1980,783500
6762813282,2680,9,2680,0,2,2004,775000
6762815716,2280,7,1140,1140,4,1900,628000
6762824246,2200,8,1570,630,3,1988,365000
6762825730,2530,8,2010,520,4,1990,331950
6762810164,13540,12,9410,4130,7,1999,2280000
6762810615,2220,9,2220,0,2,2000,1430000
6762810636,4010,9,2850,1160,5,1971,1400000
6762811248,4340,11,4340,0,4,1992,1090000
6762811411,3190,9,1690,1500,5,1976,1030000
6762812053,1330,7,1330,0,3,1928,900000
6762812148,4420,10,3410,1010,4,2006,890000
6762812149,4490,10,3200,1290,5,2006,890000
6762812331,3690,10,3690,0,4,1998,865000
6762812415,2600,8,1300,1300,4,1960,855000
6762812659,2170,9,1610,560,4,1982,831000
6762812664,3400,9,3400,0,4,2007,830000
6762812761,2920,9,2780,140,6,1908,823000
6762812961,3180,10,3180,0,5,1990,800866
6762812963,3240,10,3240,0,3,1994,800000
6762813152,1330,8,1330,0,3,1961,787000
6762813210,2730,9,2730,0,4,1996,780000
6762813361,2350,8,1810,540,3,1939,770000
6762813551,2120,7,1620,500,4,1960,755000
6762813766,2010,7,2010,0,4,1902,740000
6762813838,3180,9,3180,0,4,2000,736500
6762814206,2450,8,2450,0,4,2013,712198
6762814291,2490,9,2490,0,3,2003,705380
6762814896,1680,9,1680,0,3,1909,670000
6762814966,2800,8,1660,1140,4,1963,665000
6762815131,1390,7,1050,340,4,1924,657100
6762815226,2160,8,1400,760,3,1949,650000
6762815643,2440,9,2440,0,4,2014,631625
6762815727,1990,8,1210,780,4,1973,627000
6762815880,1480,9,1480,0,3,2005,620000
6762815955,1800,7,1080,720,3,1942,618500
6762815987,2300,9,1960,340,4,1977,615000
6762816274,1670,8,1670,0,3,1976,600000
6762816275,1880,7,1040,840,3,1945,600000
6762816667,1770,6,1520,250,2,1949,585000
6762816779,2540,8,1320,1220,2,1942,580000
6762817053,2010,8,1330,680,3,1975,570000
6762817314,1900,8,1900,0,3,1987,560000
6762817450,1940,8,1940,0,3,2009,555000
6762817755,1140,7,1140,0,2,1908,549000
6762817756,2910,8,2910,0,4,2008,549000
6762817929,2740,8,1370,1370,5,1960,541125
6762818230,1270,8,1110,160,2,2000,531000
6762818400,2550,7,1810,740,5,1960,525888
6762818543,1560,6,780,780,3,1944,524000
6762818924,1790,8,1790,0,3,2010,509900
6762819061,2070,7,1160,910,4,1963,501000
6762819262,2910,7,2910,0,4,2006,499000
6762819312,3200,8,1600,1600,6,1953,497300
6762819594,2010,7,1470,540,4,1977,487585
6762819620,2340,8,1340,1000,4,1979,485000
6762819874,3040,9,3040,0,3,2007,478000
6762820970,1480,7,1480,0,4,1928,449250
6762821445,1840,7,1540,300,5,1942,435000
6762822174,1590,8,1590,0,2,2014,419190
6762822204,1410,7,1410,0,3,1930,418000
6762822246,1408,8,1408,0,3,2005,416286
6762822266,1620,8,1540,80,3,2010,415000
6762822453,1800,8,1360,440,3,1978,410000
6762822604,1410,8,1410,0,3,2005,406100
6762822620,1410,8,1140,270,2,2006,405000
6762822792,2110,7,2110,0,2,1948,400000
6762822793,840,7,840,0,2,1955,400000
6762823019,2230,7,2230,0,3,1954,398750
6762823544,3090,8,1750,1340,5,1968,384900
6762823717,1970,7,1140,830,4,1960,379950
6762824223,1571,8,1571,0,3,2008,366750
6762825311,1120,7,1120,0,5,1962,340000
6762825312,1160,7,1160,0,2,2001,340000
6762825869,1140,6,1140,0,2,1949,329950
6762825928,2370,9,2370,0,4,1998,328000
6762826775,2310,7,2310,0,4,2006,309950
6762826776,1880,7,1880,0,3,1994,309950
6762827057,1050,7,1050,0,3,1986,300000
6762827694,1450,7,1450,0,3,1953,287000
6762829320,1550,6,1550,0,3,1958,249950
6762829453,1920,7,1000,920,3,1984,245000
6762829917,1200,6,1200,0,2,1958,232000
6762830263,1240,7,1240,0,4,1971,220000
6762830332,1120,6,1120,0,4,1969,219900
6762830530,1340,5,1340,0,3,1953,210000
6762830531,2050,6,1430,620,5,1956,210000
6762830664,810,6,810,0,2,1944,206000
6762831089,1490,7,1490,0,3,1962,184000
6762810285,4510,10,4510,0,5,1969,1870000
6762810310,4490,10,3930,560,5,2013,1800000
6762810471,3760,9,2400,1360,4,1950,1580000
6762810939,3490,10,2280,1210,4,1928,1230000
6762811141,3370,9,1970,1400,4,1970,1140000
6762811335,2200,9,1610,590,3,2008,1050000
6762811613,2690,10,2690,0,3,2014,979000
6762811999,3020,9,2080,940,3,1954,910000
6762812370,3740,9,3740,0,4,2000,860000
6762813278,3040,8,3040,0,4,2008,776000
6762813464,3880,10,3880,0,4,1987,762300
6762813840,2290,9,2290,0,4,1988,736000
6762813978,3200,10,3200,0,4,1998,725126
6762814626,3030,9,3030,0,4,1999,685000
6762814788,930,6,930,0,2,1951,675000
6762815143,3380,8,3380,0,4,2000,655500
6762815227,1630,7,1160,470,3,1940,650000
6762815228,3480,8,2490,990,5,1983,650000
6762816060,2060,7,1030,1030,4,1949,612500
6762816083,2450,8,1580,870,4,1967,610000
6762816134,2150,9,2150,0,4,1985,609000
6762816173,2110,9,2110,0,4,1987,606000
6762816405,2260,8,1400,860,4,1977,599000
6762816780,3569,10,3569,0,4,2013,580000
6762816917,2130,8,1170,960,3,1954,575000
6762817272,3100,8,2400,700,4,1996,563000
6762817288,3040,8,3040,0,5,1984,562000
6762817305,2000,7,2000,0,3,1916,561000
6762818108,1850,8,1850,0,3,1991,535000
6762818202,1800,7,1400,400,5,1926,533000
6762818237,2910,7,1690,1220,5,1964,530000
6762818403,2970,9,1770,1200,3,1995,525000
6762818591,2460,8,2460,0,3,1980,520000
6762818667,1430,7,1430,0,3,1956,518000
6762818718,1790,8,1790,0,3,1989,515000
6762818810,2000,8,2000,0,4,1996,513000
6762819071,1480,8,1480,0,3,2006,500000
6762819263,1170,7,740,430,2,1903,499000
6762819584,2020,7,2020,0,5,1938,488000
6762819621,1420,7,1420,0,3,1905,485000
6762819707,1660,7,1160,500,2,1942,484000
6762819714,2740,8,2740,0,4,1995,483500
6762819923,3470,7,3470,0,6,1924,475000
6762820190,1030,7,1030,0,2,1924,469000
6762820263,1970,8,1180,790,3,1967,465000
6762820431,1230,8,1020,210,2,2004,460000
6762820605,2240,7,1340,900,5,1978,455000
6762820766,1100,7,1100,0,2,1912,450000
6762821835,1520,7,1520,0,4,1967,425000
6762822588,2810,7,1710,1100,4,1958,407000
6762822705,1840,7,960,880,4,1958,404000
6762823058,1440,7,1200,240,4,1971,397000
6762823244,1260,7,1260,0,3,1966,390000
6762823245,2890,7,1310,1580,5,2006,390000
6762823419,1230,7,1230,0,3,1962,387000
6762823456,1900,7,1280,620,3,1982,385000
6762823727,1500,7,1000,500,4,1955,379900
6762824138,1270,8,1270,0,3,2006,369950
6762824202,1410,8,1410,0,3,1961,367500
6762824247,1310,7,1310,0,3,1950,365000
6762824373,1640,7,1140,500,3,1963,362000
6762824403,2680,8,2680,0,4,1965,360000
6762824756,1350,6,860,490,3,1947,353000
6762825130,2331,8,2331,0,4,2007,345000
6762825131,1110,7,1110,0,3,1956,345000
6762825904,720,6,720,0,2,1942,329350
6762825992,1890,7,980,910,4,1980,325000
6762826596,1510,6,860,650,3,1940,313950
6762826630,1300,7,1300,0,4,1950,312000
6762827348,1980,9,1560,420,3,1974,295000
6762827837,2000,7,2000,0,4,2003,284000
6762827916,1630,7,1630,0,3,1971,280000
6762828037,1580,7,1100,480,3,1962,279900
6762828331,1650,7,1650,0,3,1998,272000
6762829190,1050,6,1050,0,3,1954,250000
6762829881,1490,7,1010,480,3,1975,234000
6762830340,900,6,900,0,2,1952,219000
6762830360,1850,8,1320,530,3,1979,218000
6762830890,1690,7,1060,630,3,1976,197000
6762830971,800,6,800,0,3,1959,191000
6762831182,1010,7,1010,0,3,1954,175000
6762831495,1420,6,1420,0,3,1962,136500
6762831616,780,5,780,0,2,1942,78000
6762810052,6210,11,4760,1450,7,1910,3200000
6762810519,4270,11,3400,870,5,2007,1530000
6762810536,3560,11,3560,0,6,1914,1500000
6762810736,2960,10,2440,520,3,1937,1340000
6762811104,4460,11,4460,0,4,2001,1150000
6762811190,2310,7,1890,420,4,1950,1110000
6762811389,3900,10,3900,0,4,2006,1040000
6762811814,1890,9,1470,420,4,1963,940000
6762812054,4130,9,3170,960,5,1985,900000
6762813091,2210,8,1210,1000,4,1954,794154
6762813283,2540,8,1600,940,3,1905,775000
6762813540,2410,7,1780,630,4,1956,758000
6762813601,2520,7,1360,1160,3,1946,750000
6762813688,2600,8,1960,640,4,1949,749950
6762814292,2650,8,1520,1130,4,1905,705000
6762814540,1760,7,980,780,3,1942,690000
6762814789,1680,8,1680,0,3,1959,675000
6762814790,3680,10,3680,0,4,1990,675000
6762815215,3240,10,3240,0,3,1991,651000
6762815462,2270,9,2130,140,3,2002,640000
6762815655,2680,8,2680,0,3,1995,630000
6762815656,2550,10,1720,830,2,2011,630000
6762815957,2030,8,2030,0,3,1988,618080
6762816079,1680,8,1680,0,3,2014,610950
6762816276,2460,9,1860,600,3,1977,600000
6762816384,3830,7,2450,1380,9,1938,599999
6762816406,1960,7,1090,870,3,1920,599000
6762816769,2510,7,1280,1230,4,1961,581000
6762816918,1650,7,1650,0,4,1955,575000
6762817146,2350,8,1780,570,3,1929,568000
6762817315,4120,9,3180,940,3,1994,560000
6762817316,1860,8,1860,0,3,1985,560000
6762817937,3700,8,3700,0,7,1948,540000
6762818109,2720,9,2720,0,3,1988,535000
6762818110,2280,8,1880,400,3,2006,535000
6762818238,1340,7,1080,260,3,1910,530000
6762818388,1550,7,1550,0,2,1900,526000
6762818648,1170,8,1170,0,3,2014,519950
6762818719,1580,7,1210,370,3,1967,515000
6762818846,2430,8,2430,0,4,2003,510000
6762819032,1540,7,1210,330,3,1980,503000
6762819072,1010,7,1010,0,2,1906,500000
6762819073,1940,8,1940,0,3,1987,500000
6762819343,990,6,990,0,3,1943,495000
6762819344,2656,9,2656,0,4,2014,495000
6762819436,3305,7,2245,1060,4,1922,492000
6762819622,1610,7,1010,600,3,1917,485000
6762819760,2180,8,2180,0,4,1968,480500
6762819924,820,7,820,0,2,1921,475000
6762820432,1760,7,1760,0,3,1985,460000
6762821207,1500,6,1060,440,3,1947,440000
6762821771,1350,8,1350,0,2,2003,428000
6762821836,1150,8,1150,0,2,2008,425000
6762822055,1040,6,1040,0,2,1904,420000
6762822056,1770,7,1770,0,3,1977,420000
6762822226,1606,8,1606,0,3,2009,417250
6762822267,1830,7,1830,0,4,1991,415000
6762822547,2140,7,1320,820,4,1968,409500
6762822621,1660,8,1660,0,3,1961,405000
6762823625,3000,7,1500,1500,5,1958,380000
6762823740,1640,7,840,800,2,1978,379500
6762823823,1830,8,1830,0,3,1990,375000
6762824248,2410,7,1410,1000,5,2008,365000
6762824389,820,7,820,0,2,1944,361280
6762824800,2420,7,1620,800,5,1978,352000
6762824831,1010,6,1010,0,3,1981,350000
6762825419,1630,7,1630,0,3,1985,339950
6762825420,820,8,820,0,2,2006,339950
6762825551,1570,7,1570,0,3,1952,335000
6762826573,1040,7,1040,0,3,1968,314950
6762826582,1870,8,1870,0,3,1957,314500
6762826607,2190,8,2190,0,3,1967,313000
6762826675,1840,7,1220,620,3,1974,310000
6762826676,2070,7,1420,650,3,1973,310000
6762826883,1600,7,1600,0,3,2013,305450
6762827058,760,6,760,0,2,1913,300000
6762827917,1600,7,1600,0,3,2000,280000
6762828163,1600,8,1600,0,3,1993,275000
6762828606,1500,6,760,740,5,1920,265000
6762829003,2060,7,1030,1030,5,1962,255000
6762829120,1250,7,1250,0,3,1994,253000
6762829191,1100,6,820,280,1,1947,250000
6762829348,1110,7,1110,0,3,1952,249000
6762829374,1720,7,1720,0,4,1960,248500
6762829434,1400,6,1400,0,3,1944,246000
6762829454,1260,7,1040,220,3,2005,245000
6762829711,1410,7,1410,0,3,1985,239900
6762829943,1920,8,1920,0,3,1988,230000
6762830103,1640,7,1130,510,3,1988,226500
6762830601,1380,7,1380,0,3,1960,209950
6762831054,1490,7,1490,0,4,1969,185000
6762831337,1040,6,1040,0,2,1912,160000
6762831587,910,6,910,0,2,1956,100000
6762810338,3510,10,3510,0,6,1906,1750000
6762810537,2430,8,1340,1090,3,1952,1500000
6762810781,2800,10,1910,890,5,1932,1310000
6762810889,3820,11,3310,510,4,1990,1250000
6762811336,2920,8,1460,1460,4,1964,1050000
6762811390,3410,8,2190,1220,4,1910,1040000
6762811575,2015,9,2015,0,3,2007,988500
6762811596,3160,9,1780,1380,5,1971,980000
6762811867,2640,9,1840,800,3,1912,930000
6762812323,2920,10,2920,0,3,2008,868500
6762812615,1910,8,1910,0,4,1941,835000
6762812665,3040,9,1970,1070,5,1968,830000
6762813158,3010,9,3010,0,3,2011,785000
6762813211,2480,7,1390,1090,4,1950,780000
6762813572,2660,9,2660,0,4,2003,753888
6762814111,1690,8,1690,0,3,1928,719000
6762814139,3290,9,3290,0,4,2002,716500
6762814207,1250,7,1150,100,3,1900,712000
6762815046,1320,7,1320,0,3,1918,660000
6762815378,2060,8,1160,900,4,1947,647500
6762815557,1230,7,1230,0,2,1925,636000
6762815988,1540,7,820,720,2,1946,615000
6762816464,1750,7,1750,0,3,1991,595000
6762816607,3160,7,3160,0,2,1993,589900
6762817133,2250,8,2250,0,4,1980,569000
6762817390,1870,8,1870,0,2,2006,559950
6762817519,1360,8,1050,310,2,1997,553650
6762817818,1780,8,1780,0,3,1988,545000
6762817894,2820,7,1970,850,6,1940,543200
6762818056,1840,7,1220,620,4,1967,538000
6762818068,2550,7,2550,0,4,2005,537500
6762818111,2280,8,2280,0,4,2004,535000
6762818203,1670,7,1170,500,3,1967,533000
6762818239,1980,8,1980,0,3,1973,530000
6762818240,2280,7,1540,740,4,1930,530000
6762818544,2430,8,2430,0,3,1974,524000
6762818720,1060,7,1060,0,2,1926,515000
6762819074,1410,8,1410,0,3,2012,500000
6762819264,1110,8,930,180,2,2005,499000
6762819418,2310,8,2310,0,3,2011,494000
6762819551,2440,8,2440,0,5,1975,489990
6762820767,1510,7,1510,0,3,1954,450000
6762821186,1020,8,1020,0,2,2008,441750
6762821371,980,8,980,0,2,2010,438000
6762821403,1310,7,1310,0,3,1976,437000
6762821994,1460,7,1460,0,3,1979,424500
6762822396,1540,8,1470,70,3,2008,413450
6762822622,1020,7,1020,0,2,1948,405000
6762822722,2090,8,2090,0,3,2012,403000
6762822747,1960,7,1290,670,3,1977,402000
6762823457,1890,7,1230,660,3,1944,385000
6762823824,3206,7,3206,0,6,2012,375000
6762824560,960,7,960,0,2,1993,358000
6762824832,2250,8,2150,100,4,1940,350000
6762825043,1590,7,1590,0,3,1988,349000
6762825083,2460,9,2460,0,4,1989,347500
6762825552,2240,7,1480,760,3,1980,335000
6762825746,1550,7,1550,0,2,1972,330000
6762825986,2320,8,2320,0,4,2004,325900
6762826223,860,7,860,0,2,2007,321950
6762826837,1890,7,1890,0,3,1966,307000
6762827311,1240,7,1240,0,3,1967,297950
6762827349,2200,7,1100,1100,2,1973,295000
6762827350,1920,8,1920,0,3,1993,295000
6762828376,1810,7,1810,0,4,1994,270000
6762828590,1940,7,1460,480,3,1989,266000
6762828756,2020,7,2020,0,4,2002,262000
6762828791,2130,7,1100,1030,4,1962,260000
6762828930,1730,7,1230,500,4,1977,258000
6762829435,1390,7,1390,0,3,1975,246000
6762829455,1260,7,1260,0,3,1955,245000
6762829790,1270,6,650,620,2,1923,235000
6762829944,950,6,790,160,3,1939,230000
6762829945,1390,6,1390,0,3,1960,230000
6762830053,1190,7,1190,0,3,2002,229000
6762830075,2000,7,1100,900,4,1965,228000
6762830520,2100,7,1050,1050,4,1959,211000
6762830646,1490,7,1490,0,3,1954,207000
6762830682,720,6,720,0,2,1955,205000
6762831507,980,7,980,0,2,1922,134000
6762831612,520,5,520,0,2,1951,82500
6762810135,3000,11,3000,0,3,2001,2400000
6762810176,7270,12,6420,850,5,2010,2240000
6762810365,5190,11,3390,1800,5,1987,1700000
6762810697,3720,10,1960,1760,4,1962,1370000
6762811086,5860,10,4910,950,4,1996,1160000
6762811582,4230,11,4230,0,4,1989,985000
6762811939,3750,10,3750,0,4,1976,920000
6762812447,3560,10,3560,0,3,1987,851000
6762812596,3810,9,2560,1250,4,2013,839900
6762812648,3780,10,3780,0,4,1999,833000
6762812964,3540,9,3540,0,4,2007,800000
6762813195,2830,10,1980,850,4,1979,782000
6762813396,2730,8,2400,330,4,2006,769900
6762813413,2790,10,2790,0,4,1996,765000
6762813532,2950,9,2950,0,3,2006,759000
6762813758,3100,8,2000,1100,4,1919,742500
6762814293,2200,8,2200,0,2,2007,705000
6762816084,2480,8,1620,860,3,1976,610000
6762816237,2260,9,2260,0,4,1989,604000
6762816548,2430,9,2430,0,4,1993,590000
6762816668,2400,8,2400,0,4,1982,585000
6762816748,2660,8,2660,0,4,2001,583000
6762816781,2840,9,2840,0,4,1998,580000
6762817174,1660,8,1370,290,3,1980,566000
6762817182,2470,8,2470,0,4,1984,565000
6762817428,2840,8,2840,0,4,2012,557000
6762817907,2330,8,2330,0,4,1978,542500
6762818086,2000,7,1450,550,4,1926,536500
6762818089,1300,7,1300,0,3,1925,536000
6762818218,3480,8,2340,1140,5,1976,532000
6762818404,2030,8,2030,0,3,1991,525000
6762818835,1400,7,1400,0,3,1963,511555
6762818980,2100,8,2100,0,3,1999,505000
6762819453,1750,7,1300,450,3,1987,491300
6762819464,1840,6,1130,710,2,1910,490000
6762819748,1410,7,1410,0,3,1940,481450
6762820264,1930,9,1930,0,4,1968,465000
6762820383,1150,7,1150,0,2,1905,463000
6762820433,1750,7,1050,700,4,1926,460000
6762821052,1650,7,1000,650,4,1959,445000
6762821053,1150,7,860,290,2,1940,445000
6762821613,2170,8,1270,900,4,1960,431000
6762821767,1620,7,1620,0,3,1911,428750
6762822268,3060,8,3060,0,4,1992,415000
6762822734,2600,10,2600,0,4,1988,402500
6762823420,1445,7,1300,145,3,2003,387000
6762823591,1410,8,1410,0,3,2005,382000
6762823809,1340,8,1340,0,3,2008,376000
6762824404,1420,7,1180,240,2,1956,360000
6762824801,1640,8,1640,0,3,1972,352000
6762825517,1780,6,1780,0,3,1979,336900
6762825747,1940,8,1940,0,4,2003,330000
6762825993,1352,8,1352,0,3,2007,325000
6762825994,1470,7,1470,0,4,1976,325000
6762826170,998,7,798,200,3,2007,324000
6762826183,1970,8,1170,800,4,1977,323000
6762826240,2310,8,2310,0,4,1980,320000
6762826462,2320,7,1160,1160,5,1956,315000
6762826631,1930,7,1430,500,4,1984,312000
6762826656,2130,7,1380,750,4,1977,311100
6762826998,1060,7,1060,0,3,1973,303500
6762827527,2000,7,1200,800,4,1968,290000
6762827904,1390,7,840,550,3,1912,280950
6762827918,2190,7,1180,1010,4,1977,280000
6762828164,1390,6,1390,0,3,1922,275000
6762828377,1500,7,1500,0,3,1953,270000
6762828378,1690,7,1690,0,3,1969,270000
6762828792,1920,7,1510,410,3,1969,260000
6762828793,1420,7,1020,400,3,1963,260000
6762829004,960,6,960,0,2,1984,255000
6762829005,810,6,810,0,2,1928,255000
6762829097,1850,8,1850,0,3,2003,254000
6762829137,1030,7,880,150,3,1947,252500
6762829174,1220,7,1220,0,3,1962,251000
6762829381,2163,7,2163,0,4,2006,248000
6762829871,1360,6,1360,0,3,1977,234950
6762830119,2000,7,2000,0,3,1992,225000
6762830205,1430,7,1430,0,4,1983,224500
6762830502,1020,7,1020,0,2,2004,212000
6762830765,1160,7,1160,0,3,1959,201500
6762830909,720,6,720,0,2,1950,195000
6762812241,2520,8,1400,1120,4,1921,875000
6762817744,3060,8,1600,1460,5,1979,549900
6762823173,1350,8,1270,80,3,2006,394950
6762826241,2130,7,2130,0,3,2003,320000
6762828607,1940,7,1080,860,4,1962,265000
6762812556,2160,9,2160,0,4,1902,842500
6762824180,1370,7,1010,360,3,2007,368000
6762810472,3650,10,2360,1290,5,1975,1580000
6762810715,3380,8,1690,1690,5,1963,1350000
6762810768,3460,10,2560,900,4,2004,1320000
6762810794,2330,9,2330,0,4,1918,1300000
6762810875,3490,9,3490,0,4,2012,1260000
6762810940,5420,11,3890,1530,4,2001,1230000
6762810941,3070,9,1870,1200,4,1976,1230000
6762810999,1560,6,1560,0,3,1928,1200000
6762811266,3720,11,3720,0,3,1982,1080000
6762811337,3280,10,2320,960,4,2008,1050000
6762811412,3270,9,3110,160,4,2014,1030000
6762811437,2920,9,1800,1120,3,1954,1020000
6762811743,4530,9,3200,1330,5,2003,950000
6762811798,3290,10,3290,0,4,1968,947500
6762811799,2980,8,2180,800,3,1917,947500
6762811886,3300,8,3300,0,4,1953,927000
6762812000,2700,8,1350,1350,3,1962,910000
6762812055,4700,10,3420,1280,4,1978,900000
6762812184,2830,9,2830,0,4,1995,885000
6762812239,2170,9,1650,520,3,1928,876650
6762812293,2350,8,1690,660,4,1910,870300
6762812452,2350,8,2350,0,4,1961,850000
6762812564,2600,7,1620,980,4,1936,840000
6762812899,4630,9,3210,1420,5,2006,809000
6762813146,3680,9,2840,840,4,2003,788000
6762813362,1720,9,1720,0,3,1954,770000
6762813589,3110,9,3110,0,4,2004,751000
6762813602,2980,9,2890,90,4,2000,750000
6762813724,2620,9,2620,0,3,1992,746000
6762813877,2760,7,1680,1080,4,1928,734200
6762814541,2670,9,2670,0,4,1989,690000
6762814791,2400,7,1200,1200,4,1964,675000
6762815047,2550,8,1290,1260,4,1964,660000
6762815381,3040,8,3040,0,4,1999,647000
6762815563,1570,8,1570,0,3,2010,635000
6762815657,1770,7,1770,0,4,1911,630000
6762815881,1620,8,1280,340,3,1954,620000
6762815989,2040,7,2040,0,2,1919,615000
6762816085,2110,7,1640,470,4,1930,610000
6762816763,2120,7,1190,930,4,1951,582000
6762817317,2560,8,2560,0,3,1986,560000
6762817938,2540,8,1450,1090,4,1990,540000
6762818572,1800,8,1360,440,4,1980,522000
6762818981,1940,7,1030,910,4,1922,505000
6762818982,2780,8,1590,1190,4,1978,505000
6762819075,1290,8,1290,0,2,2007,500000
6762819228,980,7,760,220,3,1941,499950
6762819465,1230,8,870,360,2,2004,490000
6762820265,2020,6,1190,830,3,1956,465000
6762820698,2010,8,1390,620,3,2014,453246
6762820768,1770,8,1160,610,3,1959,450000
6762822057,1480,7,1480,0,2,2009,420000
6762822454,2200,8,2200,0,3,1987,410000
6762823563,2160,8,2160,0,4,2010,383000
6762824005,2480,7,1300,1180,5,2004,372500
6762824160,980,8,670,310,2,2009,369000
6762824181,1280,7,1280,0,3,1968,368000
6762824405,1730,7,1010,720,4,1943,360000
6762824594,2380,7,2380,0,4,1997,357000
6762824833,910,7,910,0,2,1906,350000
6762825297,1720,7,1720,0,3,1952,341000
6762825447,1080,7,1080,0,3,1955,339000
6762825553,1940,8,1940,0,3,2004,335000
6762825748,2100,7,1250,850,5,2013,330000
6762826459,1440,7,960,480,3,1951,315275
6762827026,2180,7,2180,0,5,1986,302000
6762827044,830,7,830,0,2,2005,301500
6762827059,1360,7,860,500,2,1975,300000
6762828379,1830,7,1830,0,3,1942,270000
6762828608,1290,7,1290,0,2,2008,265000
6762829006,1220,6,770,450,2,1910,255000
6762829791,810,7,810,0,1,1941,235000
6762830120,990,7,990,0,3,1966,225000
6762830521,1350,6,1350,0,3,1941,211000
6762830532,1040,7,720,320,3,2004,210000
6762830767,1460,7,1460,0,3,1969,201000
6762830967,700,6,700,0,2,1953,192000
6762831055,1370,7,1370,0,3,1961,185000
6762831383,970,7,970,0,3,1959,156000
6762831569,1250,6,1250,0,3,1945,110000
6762810108,5300,10,4570,730,4,1923,2560000
6762810128,4430,10,4430,0,5,2013,2450000
6762810129,5030,11,3250,1780,4,2008,2450000
6762810260,3120,9,3120,0,5,1969,1900000
6762810391,4860,11,3820,1040,5,1989,1680000
6762810503,3370,10,2000,1370,5,1982,1550000
6762810637,3530,10,3530,0,5,2001,1400000
6762811191,2740,9,1930,810,4,1905,1110000
6762811338,4400,11,4400,0,4,2003,1050000
6762811620,3490,11,3490,0,4,2000,975000
6762812294,3520,9,2650,870,4,2006,870000
6762812371,3560,10,2290,1270,4,1986,860000
6762812797,3150,9,3150,0,5,2013,819900
6762813033,2890,7,2290,600,6,1906,799200
6762813212,2340,8,2340,0,3,1967,780000
6762813274,3610,10,2440,1170,3,2003,777000
6762813357,1780,9,1390,390,3,1927,771000
6762813543,3190,9,3190,0,3,2007,757000
6762814133,1310,7,1090,220,3,1956,717000
6762814341,2030,9,2030,0,3,1975,700000
6762814792,3000,9,3000,0,4,2006,675000
6762814793,3410,8,1870,1540,5,1968,675000
6762814967,1940,7,1150,790,3,1944,665000
6762815048,3400,9,3400,0,4,2012,660000
6762815216,2740,8,2740,0,4,1993,651000
6762815229,2210,9,2210,0,4,2013,650000
6762815391,1740,9,1740,0,3,1975,645000
6762815564,1950,8,1370,580,4,1969,635000
6762815717,2260,8,1430,830,4,1958,628000
6762815751,1810,8,1440,370,3,2009,625000
6762815882,1710,7,1710,0,3,1909,620000
6762816544,1680,7,870,810,3,1922,591000
6762816545,2710,8,2710,0,4,1977,591000
6762816770,2090,8,1070,1020,4,1963,581000
6762816782,2290,7,1190,1100,5,1964,580000
6762816919,1580,7,1180,400,3,1951,575000
6762817054,1530,7,1530,0,3,1937,570000
6762817318,1440,7,1440,0,3,1910,560000
6762817572,2250,7,1200,1050,4,1956,550000
6762817573,3440,7,3440,0,7,1970,550000
6762818241,1680,8,1680,0,2,2006,530000
6762818242,1690,8,1690,0,3,1958,530000
6762818405,2450,7,2450,0,5,1994,525000
6762818406,2876,8,2360,516,3,2007,525000
6762818407,1580,8,1010,570,3,2008,525000
6762818556,1240,7,1240,0,3,1957,523000
6762818983,2790,8,2790,0,4,2009,505000
6762819047,2040,8,2040,0,4,2012,502000
6762819761,3830,8,2130,1700,5,1976,480000
6762819925,3740,10,2260,1480,4,2004,475000
6762820266,1270,7,1270,0,3,1950,465000
6762820365,3400,8,1700,1700,5,1959,464000
6762820434,2350,8,1390,960,3,1977,460000
6762820606,3360,9,3360,0,4,2001,455000
6762820769,1250,8,1040,210,3,2010,450000
6762820770,2450,7,2450,0,3,1978,450000
6762820961,1770,7,960,810,3,1954,449500
6762821446,2140,7,2140,0,4,2002,435000
6762822269,1960,6,980,980,3,1911,415000
6762822400,1410,7,810,600,4,1925,413000
6762822623,2180,7,1090,1090,4,1956,405000
6762823458,1480,7,740,740,3,1943,385000
6762823825,1190,7,1190,0,3,1953,375000
6762823993,3001,8,3001,0,5,2006,373000
6762824049,1650,7,1060,590,3,1951,370000
6762824724,1490,8,1490,0,3,2004,354901
6762824834,2010,7,2010,0,3,1977,350000
6762825132,1090,7,1090,0,3,1968,345000
6762825749,1450,7,840,610,3,2007,330000
6762826200,1350,7,1350,0,3,1989,322500
6762826372,1390,7,1390,0,3,1968,319000
6762827643,1090,6,1090,0,3,1981,289000
6762827683,1950,7,1950,0,3,1990,287600
6762827695,1490,7,1170,320,3,1987,287000
6762827751,1090,6,1090,0,3,1973,285000
6762828308,2180,6,1280,900,4,1954,273000
6762828565,2510,7,1610,900,4,1972,267345
6762829456,2020,7,1220,800,5,1962,245000
6762829699,1900,5,1900,0,3,1942,239950
6762829946,650,5,650,0,2,1931,230000
6762830121,1250,7,1250,0,3,1967,225000
6762830122,1950,6,1950,0,4,1939,225000
6762830123,1040,6,1040,0,3,1947,225000
6762830124,1660,7,1100,560,3,1963,225000
6762831389,910,6,910,0,2,1943,155000
6762831600,790,7,790,0,2,1973,90000
6762810277,3260,10,2170,1090,4,1968,1880000
6762810638,2550,10,2550,0,3,1981,1400000
6762810964,4910,11,3110,1800,4,2007,1220000
6762811178,4470,11,4470,0,4,1988,1120000
6762811315,2290,8,2290,0,4,1955,1060000
6762811680,3810,10,3810,0,5,2008,966000
6762811728,2510,8,2510,0,5,1972,955000
6762811744,3320,10,3320,0,4,1995,950000
6762811868,3100,10,3100,0,3,1954,930000
6762811893,2190,8,2190,0,4,1958,925000
6762812953,2580,9,2580,0,3,1986,802000
6762812965,1700,8,1700,0,3,1906,800000
6762813345,2470,9,2470,0,3,2007,773000
6762813410,3030,10,3030,0,3,1992,766950
6762813767,5774,11,4490,1284,5,1984,740000
6762813768,3430,10,3430,0,4,2000,740000
6762814048,2700,9,2700,0,4,2004,723000
6762814151,2060,8,1360,700,4,1941,715000
6762814279,3200,9,3200,0,4,2004,707000
6762814330,2360,7,1930,430,3,1926,702500
6762814678,1830,8,1830,0,3,1903,682000
6762815626,2470,9,2470,0,4,1993,633100
6762815752,1680,7,1680,0,4,1966,625000
6762815883,2540,8,1760,780,5,1929,620000
6762816155,2220,7,1420,800,5,1923,607500
6762816759,1159,7,1159,0,2,1948,582500
6762817183,2240,9,2240,0,4,1989,565000
6762817289,1830,7,1830,0,3,1957,562000
6762817805,2000,7,1110,890,3,1921,546000
6762817896,2090,7,1360,730,3,1962,543000
6762817897,2370,7,1600,770,2,1992,543000
6762817915,1900,7,950,950,4,1955,542000
6762818057,1400,6,1100,300,3,1904,538000
6762818243,2450,9,2450,0,4,1974,530000
6762818408,1600,7,1600,0,3,1924,525000
6762818839,1820,9,1820,0,3,2005,511000
6762818847,2170,8,1450,720,3,1986,510000
6762819265,2090,7,2090,0,3,1959,499000
6762819300,2270,7,1290,980,4,1973,498000
6762819564,1850,7,1850,0,3,1965,489200
6762819613,2150,7,1420,730,4,1978,486000
6762820115,2310,9,2310,0,4,1991,470000
6762820553,1660,7,1060,600,3,1940,458000
6762820771,2910,10,2910,0,3,1989,450000
6762821404,2580,8,2580,0,3,2008,437000
6762822058,3040,8,3040,0,4,1999,420000
6762822618,840,6,840,0,2,1947,405100
6762822794,980,6,860,120,2,1918,400000
6762823180,830,6,830,0,2,1955,394475
6762823459,1620,7,860,760,4,1947,385000
6762824004,1690,8,1150,540,3,2014,372977
6762824014,1290,7,980,310,3,1951,372220
6762824335,2010,7,1340,670,4,1957,364000
6762824613,2100,9,2100,0,3,1980,356000
6762825005,2257,8,1363,894,5,2005,349950
6762825133,2120,7,2120,0,3,1984,345000
6762825313,1970,7,1970,0,3,1997,340000
6762825421,1050,7,1050,0,3,1906,339950
6762825494,1700,7,1000,700,5,1956,337500
6762825995,2220,8,2220,0,3,1990,325000
6762826418,1840,8,1840,0,3,2012,317000
6762826439,2010,8,2010,0,4,1995,316000
6762826677,1050,7,1050,0,3,1953,310000
6762826678,1480,7,1480,0,3,1952,310000
6762826860,1220,8,1220,0,3,2007,306000
6762826882,2110,7,2110,0,3,1966,305495
6762826886,1590,7,1590,0,4,1966,305000
6762827060,1260,6,1260,0,3,1946,300000
6762827248,1250,7,1250,0,2,1950,299000
6762828552,700,6,700,0,2,1949,267800
6762828591,1780,7,1400,380,3,1986,266000
6762828609,1570,7,1570,0,3,1998,265000
6762828957,1850,7,1150,700,3,1952,257200
6762829121,2230,7,2230,0,4,2006,253000
6762829882,1630,7,1050,580,4,1975,234000
6762830220,1340,7,1340,0,3,1973,223000
6762830413,1240,7,1240,0,2,1967,215000
6762831183,1170,6,1170,0,2,1911,175000
6762831338,860,6,860,0,3,1963,160000
6762831390,700,6,700,0,2,1952,155000
6762831488,1100,7,1100,0,3,1978,139000
6762810208,3550,9,3550,0,4,1962,2100000
6762810876,3200,9,3200,0,4,2006,1260000
6762811105,4210,10,4210,0,4,2006,1150000
6762811249,3740,10,2000,1740,4,1988,1090000
6762811478,3920,9,2900,1020,5,1990,1000000
6762811989,3950,10,3950,0,4,2013,914500
6762812565,2930,9,1670,1260,4,1947,840000
6762812599,1230,7,1230,0,3,1955,839000
6762812694,3930,9,2820,1110,4,2013,828950
6762812796,3030,9,3030,0,5,2013,819995
6762812946,3310,9,3310,0,4,2004,803100
6762813106,1790,8,1350,440,3,1940,790000
6762813414,3580,10,3190,390,5,1999,765000
6762813702,3240,10,3240,0,4,1985,749400
6762813750,1980,8,1980,0,4,1941,744000
6762814070,3150,9,3150,0,3,2007,720000
6762814484,3150,9,3150,0,4,2001,695000
6762814485,4560,9,3800,760,3,1986,695000
6762814585,2740,9,2060,680,4,2003,689900
6762815463,2560,7,1890,670,4,1947,640000
6762815884,2680,9,2680,0,4,1989,620000
6762816051,1550,7,1550,0,4,1909,613000
6762816527,2240,9,2240,0,4,1983,592500
6762816669,2000,7,2000,0,5,1921,585000
6762816758,2550,8,1440,1110,4,1986,582800
6762816778,2360,9,2360,0,3,1996,580050
6762816920,1490,7,1090,400,2,1946,575000
6762816921,3020,9,1600,1420,4,1979,575000
6762817574,1980,8,1980,0,3,1980,550000
6762818409,2700,9,2700,0,3,1991,525000
6762818821,1840,7,1840,0,3,1997,512500
6762819313,2240,8,2240,0,4,1995,497000
6762819345,2050,7,1210,840,4,1941,495000
6762819926,2870,7,1520,1350,7,1961,475000
6762820230,1660,7,1000,660,3,1946,467000
6762820258,1260,7,1260,0,3,1959,465750
6762820267,1410,7,1410,0,3,1924,465000
6762820607,1870,8,1470,400,3,1980,455000
6762820748,1320,6,1320,0,2,1912,451555
6762821633,1510,7,1230,280,3,1973,430000
6762822013,1880,7,1010,870,4,1976,423000
6762822059,1640,7,1640,0,3,1977,420000
6762822228,1340,7,1340,0,3,1956,417000
6762822406,1490,7,1490,0,3,1963,412500
6762822795,1630,7,1630,0,3,1953,400000
6762823099,1120,7,1120,0,3,1955,395300
6762823246,2240,8,2240,0,3,1996,390000
6762823438,1720,7,1720,0,3,2010,386380
6762823826,1890,7,1250,640,4,1960,375000
6762824050,2710,9,2710,0,4,1998,370000
6762824835,1680,7,1070,610,3,1940,350000
6762825006,1400,8,1400,0,3,1957,349950
6762825007,1700,8,1700,0,3,1994,349950
6762825232,1232,7,1232,0,3,2007,344000
6762825247,2290,7,1340,950,4,1960,343000
6762825271,1180,7,1180,0,3,1986,342400
6762825314,1960,7,980,980,3,1948,340000
6762825554,2150,7,2150,0,3,1991,335000
6762826434,2150,8,2150,0,4,1991,316500
6762826618,880,7,880,0,2,1919,312500
6762826632,1490,7,1220,270,3,2009,312000
6762827027,2020,7,1010,1010,4,1963,302000
6762827061,1220,7,1220,0,3,1955,300000
6762827351,850,7,850,0,3,1986,295000
6762827919,1330,5,1330,0,3,1959,280000
6762828165,1840,7,1400,440,4,2004,275000
6762828380,1010,7,1010,0,3,1969,270000
6762828733,1590,7,1590,0,3,1991,263000
6762828980,1690,8,1690,0,3,2003,256883
6762829007,2070,8,2070,0,4,1989,255000
6762829147,1650,7,1160,490,3,1979,252350
6762829192,1230,7,1230,0,3,1957,250000
6762829457,1490,7,1490,0,3,1990,245000
6762829618,1400,6,700,700,3,1948,240000
6762830125,1400,7,1150,250,3,1979,225000
6762830377,1040,7,1040,0,3,1959,217450
6762830414,1160,6,1160,0,3,1969,215000
6762830729,1670,7,1670,0,4,1967,204700
6762830885,980,6,980,0,3,1903,197500
6762830979,1090,7,1090,0,3,1967,190000
6762831056,1150,6,1150,0,3,1932,185000
6762831218,1060,6,1060,0,3,1970,174950
6762810218,6490,11,3940,2550,5,1991,2000000
6762810861,5520,9,3570,1950,4,2008,1270000
6762812242,2220,7,1220,1000,3,1947,875000
6762812363,3280,10,3280,0,4,1996,862500
6762812942,3360,9,3360,0,5,2014,804995
6762813034,3120,9,2370,750,4,2005,799000
6762813159,2180,7,1100,1080,3,1904,785000
6762813350,2110,8,2110,0,4,2000,772000
6762813906,3120,9,3120,0,4,2003,730100
6762813979,2830,9,2830,0,5,2006,725000
6762814045,2050,8,1180,870,3,1926,724800
6762814071,2020,7,1700,320,2,1947,720000
6762814794,3200,9,3200,0,5,2009,675000
6762815147,3690,9,3690,0,5,1977,655000
6762815392,3160,9,3160,0,4,1983,645000
6762815885,1720,7,1450,270,3,1921,620000
6762815940,2170,9,2170,0,3,2003,619500
6762815947,2720,9,2720,0,3,2005,619000
6762816074,2134,8,2134,0,3,2008,611000
6762816182,910,7,910,0,2,1909,605000
6762816183,1290,8,1290,0,3,1987,605000
6762817184,1520,8,1520,0,3,2013,565000
6762817554,2260,9,2260,0,2,1990,551000
6762817939,1140,7,1140,0,1,1920,540000
6762818557,1260,8,1260,0,3,1931,523000
6762818563,2370,9,2370,0,3,2003,522500
6762819076,1310,8,1160,150,2,2006,500000
6762819466,1450,8,1450,0,3,1900,490000
6762819467,1160,8,1160,0,2,1937,490000
6762819762,2430,7,2430,0,4,2009,480000
6762820751,1560,7,1000,560,3,1926,451000
6762821033,2270,7,1290,980,4,1977,446000
6762821054,1990,8,1990,0,3,1984,445000
6762821055,1970,8,1970,0,3,2010,445000
6762821391,2320,9,2320,0,3,1992,437500
6762821565,2280,7,2280,0,4,2001,433000
6762821634,2150,7,1200,950,3,1956,430000
6762821837,2670,10,2670,0,3,1988,425000
6762822563,1800,7,1800,0,3,1990,408200
6762822796,2740,9,2740,0,3,1973,400000
6762823460,1180,7,940,240,3,1981,385000
6762823718,1860,8,1860,0,3,2007,379950
6762823794,1410,7,1290,120,3,2005,377500
6762823827,1100,8,940,160,3,2007,375000
6762823828,2790,9,2790,0,4,2005,375000
6762824051,1370,7,900,470,4,1972,370000
6762824345,1726,7,1726,0,3,1982,363750
6762824836,700,7,700,0,1,1942,350000
6762824837,2440,7,2440,0,4,2009,350000
6762825134,1980,7,1980,0,4,1962,345000
6762825273,1260,6,720,540,3,1944,342000
6762825298,1480,9,1180,300,3,2012,341000
6762825315,1250,7,1250,0,3,1951,340000
6762825750,1170,7,1170,0,3,1960,330000
6762826419,1760,7,1060,700,3,1977,317000
6762826587,2340,8,2340,0,4,2003,314000
6762826853,2060,8,1560,500,3,1978,306500
6762826861,1870,7,1870,0,3,2005,306000
6762827872,830,6,830,0,2,1954,282613
6762828166,1480,8,1480,0,3,1987,275000
6762829098,1510,7,1510,0,4,1955,254000
6762829136,1070,7,1070,0,2,1985,252700
6762829193,1900,7,950,950,3,1966,250000
6762829349,1440,7,940,500,3,1982,249000
6762829382,1850,7,1130,720,4,1986,248000
6762829458,870,6,870,0,2,1941,245000
6762829459,1530,7,1400,130,4,1948,245000
6762829700,1460,6,1460,0,5,1941,239950
6762829712,1860,8,1120,740,4,1979,239900
6762829738,1020,7,720,300,3,2004,238000
6762830683,1730,7,1050,680,5,1978,205000
6762831120,1000,6,1000,0,3,1940,180000
6762831221,1010,7,1010,0,2,1955,174500
6762822455,1700,6,890,810,3,1944,410000
6762813895,1940,9,1940,0,3,1954,732000
6762816916,2060,8,1440,620,4,1985,575550
6762818189,2130,8,1210,920,3,1994,534640
6762819585,1360,7,780,580,2,1944,488000
6762822270,2480,8,2480,0,3,1986,415000
6762824784,1410,7,1170,240,3,1987,352500
6762827317,1970,7,1970,0,5,1994,297000
6762810209,5340,10,3740,1600,5,1912,2100000
6762810576,5010,12,5010,0,4,1988,1470000
6762810629,3410,10,3410,0,4,2008,1410000
6762810965,3190,9,1680,1510,4,1967,1220000
6762811038,2240,8,1270,970,4,1914,1190000
6762811479,2430,10,2430,0,2,1951,1000000
6762811928,2200,9,2200,0,3,1932,924000
6762812185,2730,8,1550,1180,4,1921,885000
6762812319,4180,8,2880,1300,5,1979,869000
6762812453,2640,8,2640,0,4,1937,850000
6762812805,2380,8,2380,0,2,2011,818000
6762812861,3480,11,3480,0,4,1988,810000
6762813465,3370,7,2140,1230,5,1907,762000
6762813552,2660,9,2660,0,4,1993,755000
6762813689,3430,8,3430,0,4,2013,749950
6762814342,2010,7,1230,780,3,1912,700000
6762814542,1610,8,1610,0,3,1940,690000
6762815464,1540,9,1540,0,2,2007,640000
6762816075,2460,8,2460,0,4,1998,611000
6762816255,3290,8,3290,0,5,1973,602000
6762816528,1420,7,1420,0,2,1928,592500
6762816634,2030,7,1190,840,3,1977,588000
6762816922,2500,9,2500,0,4,2013,575000
6762817023,2030,8,1500,530,3,1984,572500
6762817185,2110,8,2110,0,4,1979,565000
6762817319,1660,7,1260,400,4,1945,560000
6762818244,2320,9,2060,260,3,1997,530000
6762818410,2420,8,1480,940,4,1979,525000
6762818534,1890,7,1290,600,3,1974,524950
6762818668,1680,8,1380,300,3,2008,518000
6762819600,1690,7,1550,140,4,1901,487250
6762819623,1500,7,1370,130,3,1926,485000
6762819624,1260,8,1260,0,2,2004,485000
6762819625,2200,7,2200,0,3,1908,485000
6762819726,1450,7,980,470,3,2005,482500
6762819763,3370,9,3370,0,4,2005,480000
6762819892,1350,8,1350,0,3,2005,477000
6762819927,1490,7,860,630,2,1929,475000
6762819928,3060,8,1700,1360,4,1968,475000
6762820366,1630,8,1630,0,3,1967,464000
6762820405,1710,8,1410,300,3,1928,462000
6762820406,1250,7,1250,0,5,1966,462000
6762820417,1060,7,1060,0,2,1926,461000
6762821034,2190,7,1370,820,5,1978,446000
6762821157,1800,8,1800,0,3,1967,442500
6762821208,1010,5,1010,0,2,1906,440000
6762821559,2200,8,2200,0,3,2009,433500
6762821743,1920,8,1920,0,3,1995,429000
6762822395,770,5,770,0,2,1924,413500
6762822438,2500,8,2500,0,4,1966,411000
6762823247,2490,9,2490,0,4,1999,390000
6762823432,1690,8,1150,540,3,2014,386591
6762823994,1670,7,1670,0,3,1999,373000
6762824182,1660,6,830,830,2,1908,368000
6762824214,700,7,700,0,2,1945,367000
6762824224,2070,7,1120,950,4,1945,366500
6762824501,1290,7,1290,0,3,1960,359950
6762824838,1640,8,1640,0,3,1985,350000
6762825448,1830,7,1830,0,4,2003,339000
6762825688,1580,6,1580,0,4,1906,333000
6762826242,2680,8,2680,0,3,1990,320000
6762826350,2310,7,1650,660,4,1976,319950
6762826838,1370,7,1370,0,3,1960,307000
6762826887,1610,8,1610,0,3,1981,305000
6762827303,2100,8,1200,900,5,2007,298450
6762827327,2170,8,1380,790,3,1978,296500
6762827528,1700,7,1700,0,4,1988,290000
6762827529,2120,7,2120,0,5,1962,290000
6762827752,2080,7,1040,1040,4,1955,285000
6762827753,810,7,810,0,1,1982,285000
6762827920,1270,8,1270,0,3,1993,280000
6762827921,1720,7,1720,0,3,2005,280000
6762828983,1120,6,1120,0,2,1980,256500
6762829172,1310,7,1060,250,4,1953,251200
6762829416,1580,7,1580,0,3,1986,247000
6762829605,1470,6,1470,0,2,2005,241000
6762830126,910,7,910,0,2,1981,225000
6762830415,1610,7,1610,0,2,1979,215000
6762830416,970,7,970,0,3,1970,215000
6762830533,1080,6,1080,0,3,1942,210000
6762831476,930,5,930,0,2,1942,141800
6762831493,950,6,950,0,3,1954,137000
6762831568,680,6,680,0,2,1941,110700
6762810311,4460,9,2550,1910,4,1962,1800000
6762810346,3300,10,2600,700,4,1926,1740000
6762810386,3400,9,1820,1580,3,1957,1690000
6762810795,4380,11,4380,0,4,2001,1300000
6762810843,2850,10,1450,1400,4,1970,1280000
6762810978,4560,12,2230,2330,4,1995,1210000
6762811158,2880,8,2180,700,6,1919,1130000
6762811205,2390,8,2390,0,3,1939,1100000
6762811616,2620,9,1720,900,4,1926,978000
6762811733,3120,9,2480,640,4,2008,953007
6762811894,2260,9,2260,0,4,1967,925000
6762812228,3500,9,1830,1670,4,1938,879950
6762812372,3160,9,3160,0,4,2014,860000
6762813095,1570,8,1570,0,3,1915,792000
6762813160,3070,10,2190,880,4,2009,785000
6762813351,1640,8,1640,0,3,2014,772000
6762813415,2560,8,1760,800,4,1976,765000
6762813476,2450,9,1630,820,4,1987,760000
6762813553,2150,7,1270,880,6,1952,755000
6762813690,2770,9,2770,0,3,1992,749950
6762813908,3230,10,3230,0,4,2004,730000
6762814225,1790,7,1040,750,2,1923,710000
6762814343,1680,7,1680,0,4,1921,700000
6762814445,2650,9,2650,0,4,2006,699000
6762814795,2690,8,2690,0,4,1954,675000
6762814796,1990,8,1990,0,3,1987,675000
6762815520,2150,8,2150,0,4,1982,639000
6762815753,3550,9,3550,0,4,2007,625000
6762815886,2480,7,2480,0,3,2004,620000
6762815941,1700,8,1700,0,3,1992,619500
6762815990,2820,8,1860,960,4,1965,615000
6762816387,2660,8,2660,0,3,2014,599950
6762816441,2890,9,2890,0,5,1977,598000
6762816923,1280,7,860,420,4,1926,575000
6762817055,1540,7,1190,350,2,1908,570000
6762817451,3050,9,3050,0,3,1987,555000
6762817555,2830,9,2830,0,3,2001,551000
6762818411,1540,8,1540,0,3,1941,525000
6762818592,2680,8,2040,640,4,1942,520000
6762818650,1820,8,1820,0,4,1967,519900
6762818721,2670,9,2670,0,4,2006,515000
6762818950,2020,7,1020,1000,3,1963,507500
6762819077,1210,8,1210,0,3,2008,500000
6762819229,3200,7,3200,0,5,1989,499950
6762819419,2090,7,1250,840,4,1925,494000
6762819468,1910,7,1010,900,3,1946,490000
6762819469,4460,10,3280,1180,5,2015,490000
6762819713,1480,6,840,640,2,1951,483945
6762819764,2050,7,1180,870,4,1986,480000
6762819856,1260,8,1260,0,3,2008,479000
6762819929,1650,7,1150,500,4,1950,475000
6762820231,1270,8,1040,230,3,2005,467000
6762820554,2140,7,1470,670,1,1976,458000
6762820724,1210,6,1210,0,4,1900,452000
6762820772,2060,8,2060,0,3,1953,450000
6762821209,1300,7,1300,0,2,1948,440000
6762821210,1270,8,1270,0,3,2007,440000
6762821337,2010,8,1510,500,3,2003,439000
6762821635,1200,7,1200,0,3,1906,430000
6762821821,2800,8,2800,0,4,2004,426000
6762822014,1940,7,970,970,4,1941,423000
6762822271,1050,7,1050,0,2,1943,415000
6762822272,1970,8,1680,290,3,2008,415000
6762822549,1800,8,1800,0,3,2014,409316
6762822624,2430,9,2430,0,5,2001,405000
6762823076,1730,6,1730,0,2,1945,396675
6762823100,1080,7,1080,0,3,1920,395000
6762823248,1770,8,1190,580,4,1965,390000
6762823410,1320,7,1320,0,4,1929,387500
6762823421,1230,8,960,270,2,2012,387000
6762823461,1490,8,1490,0,3,1959,385000
6762823551,1700,7,1700,0,3,2003,384000
6762823626,2800,8,2800,0,4,2002,380000
6762823627,1690,8,1380,310,3,2008,380000
6762823810,1150,7,1150,0,2,1947,376000
6762824006,1590,7,1590,0,4,1922,372500
6762824839,2220,8,2220,0,4,1999,350000
6762825125,2800,9,2800,0,5,1903,345600
6762825135,1240,7,1240,0,3,1954,345000
6762825555,1060,7,1060,0,3,1967,335000
6762825751,860,7,860,0,2,1948,330000
6762825752,1180,6,1180,0,3,1959,330000
6762825867,2303,8,2303,0,4,2013,329995
6762825889,2170,8,2170,0,3,2004,329900
6762825905,1600,7,830,770,4,1947,329000
6762825975,1880,7,1880,0,6,1966,326000
6762825996,1870,7,1170,700,4,1959,325000
6762826243,1480,7,1480,0,3,1965,320000
6762826463,1400,7,1140,260,3,1987,315000
6762826464,790,6,790,0,2,1955,315000
6762826793,1092,6,1092,0,3,1918,309000
6762826888,1590,7,1220,370,2,2009,305000
6762827062,1090,7,1090,0,3,1955,300000
6762827063,2120,7,1060,1060,3,1967,300000
6762827064,2860,7,2860,0,6,1978,300000
6762827198,910,6,740,170,3,1950,299950
6762827509,1560,7,1560,0,3,1964,291000
6762827530,1280,7,1280,0,3,1969,290000
6762827644,2090,8,2090,0,3,2002,289000
6762827666,1860,7,1220,640,4,1983,288400
6762828366,870,6,870,0,2,1906,271310
6762828522,790,6,790,0,2,1953,268500
6762828734,1570,7,1570,0,3,1982,263000
6762828794,1990,7,1990,0,4,1989,260000
6762828897,1490,7,1490,0,3,1990,259900
6762828907,1320,7,1320,0,3,1957,259000
6762829194,1960,7,1160,800,4,1978,250000
6762829195,2500,7,1500,1000,4,1961,250000
6762829569,1770,7,960,810,2,1943,243000
6762830318,1650,7,1090,560,3,1967,219950
6762830534,2180,8,1180,1000,4,1950,210000
6762830665,1700,6,1700,0,4,1978,206000
6762830779,1050,6,1050,0,3,1967,200000
6762830945,820,8,760,60,1,2007,194000
6762830962,950,6,950,0,2,1926,192500
6762831549,1140,7,1140,0,3,1969,120750
6762810093,5305,11,3745,1560,5,2005,2700000
6762810473,3690,11,3690,0,3,2007,1580000
6762810504,4460,12,4460,0,3,1992,1550000
6762810530,3660,10,3360,300,4,1909,1510000
6762810966,3240,9,2060,1180,4,2008,1220000
6762811039,2760,10,2760,0,3,1978,1190000
6762811159,3810,10,2680,1130,4,2007,1130000
6762811294,1890,8,1890,0,2,1987,1070000
6762811413,3880,11,3700,180,3,2009,1030000
6762811480,2290,7,2170,120,4,1926,1000000
6762811621,4850,10,4850,0,5,1977,975000
6762811652,2790,9,1130,1660,4,1963,970000
6762811745,5330,10,3570,1760,5,2006,950000
6762812123,2876,9,1970,906,5,1973,895000
6762812817,3488,10,3488,0,4,1998,815000
6762813751,2830,10,2830,0,4,1998,744000
6762814072,2020,8,2020,0,3,2000,720000
6762814208,3400,9,3400,0,4,2001,712000
6762814344,3010,9,3010,0,4,1996,700000
6762814345,2780,9,2780,0,4,2006,700000
6762814534,2550,8,1700,850,4,1972,691000
6762814940,2340,8,1590,750,4,1964,668750
6762815148,2350,8,1670,680,4,1994,655000
6762815565,2750,8,1500,1250,4,1948,635000
6762815754,2630,8,2630,0,4,1986,625000
6762815944,2450,9,2450,0,4,1988,619420
6762816277,2360,8,2360,0,4,2001,600000
6762816278,2230,9,2230,0,3,1987,600000
6762816615,2910,8,2910,0,4,1998,589000
6762817167,2540,9,2540,0,3,1999,567000
6762817435,2020,8,2020,0,3,1998,556000
6762817436,1960,9,1600,360,3,2007,556000
6762817908,3010,8,2010,1000,5,1931,542500
6762817940,1300,7,1300,0,3,1983,540000
6762817941,1470,8,1000,470,3,2007,540000
6762818102,1900,8,1900,0,4,1994,535800
6762818112,1030,7,920,110,2,1939,535000
6762818412,2100,9,1510,590,3,1998,525000
6762818413,1450,8,950,500,3,1948,525000
6762818593,3290,8,3290,0,4,1992,520000
6762818822,1900,8,1900,0,3,1990,512500
6762819346,2380,8,1670,710,3,1997,495000
6762819930,1790,7,840,950,4,1909,475000
6762820725,1660,6,850,810,4,1945,452000
6762820773,1200,7,1070,130,2,1940,450000
6762821174,2080,8,1220,860,4,1979,442000
6762821636,1150,6,1150,0,3,1906,430000
6762821637,2550,8,2550,0,3,1994,430000
6762821744,2420,8,1860,560,3,1985,429000
6762822050,960,5,960,0,1,1945,420850
6762822393,1440,8,1440,0,3,2007,413800
6762822625,2470,7,1570,900,3,1962,405000
6762823082,1540,8,1540,0,3,1967,396450
6762823354,1445,7,1300,145,3,2003,389999
6762823451,1540,7,1120,420,3,1961,385500
6762823592,2880,8,2880,0,5,1990,382000
6762823980,2000,6,2000,0,3,1961,374000
6762824179,2150,8,2150,0,3,1988,368250
6762824406,850,6,550,300,2,1909,360000
6762824407,1530,8,1530,0,3,2009,360000
6762824840,980,7,980,0,3,1969,350000
6762825229,1800,7,1050,750,4,2002,344500
6762825649,2220,8,2220,0,4,2014,334990
6762825708,1800,7,1800,0,3,1995,332500
6762825753,1250,7,1250,0,3,1969,330000
6762825997,990,6,990,0,3,1947,325000
6762826393,2000,8,2000,0,4,1978,318989
6762827065,970,6,970,0,2,1949,300000
6762827221,2720,7,2720,0,3,2002,299900
6762827233,790,6,790,0,2,1925,299800
6762827667,1870,7,1870,0,3,1997,288400
6762827754,2380,7,1320,1060,3,1935,285000
6762828167,2030,7,2030,0,3,1993,275000
6762828381,1390,6,860,530,3,1957,270000
6762828795,2220,7,2220,0,6,1977,260000
6762828981,1990,7,1570,420,3,1969,256750
6762829008,1060,7,1060,0,3,1973,255000
6762829196,1170,7,1170,0,3,1984,250000
6762829333,1140,6,1140,0,2,1947,249900
6762829436,1780,7,1780,0,3,1953,246000
6762829619,1330,7,1330,0,2,1993,240000
6762829947,1930,6,1930,0,5,1941,230000
6762830127,1396,7,1396,0,2,1940,225000
6762830264,1060,7,1060,0,3,1956,220000
6762830265,2160,7,2160,0,4,1993,220000
6762830361,1020,7,1020,0,3,1956,218000
6762830535,1240,6,1240,0,3,1916,210000
6762830780,1310,6,1160,150,4,1945,200000
6762830862,2030,7,2030,0,4,1950,199000
6762830910,1380,7,990,390,3,1981,195000
6762830911,1080,8,1080,0,2,1972,195000
6762831023,1100,6,1100,0,2,1980,189650
6762831184,1230,7,1230,0,3,1962,175000
6762831422,1010,6,1010,0,3,1966,150000
6762810197,5060,11,5060,0,4,2008,2150000
6762810446,3160,9,1820,1340,3,1966,1600000
6762811058,1610,8,1090,520,3,1973,1180000
6762811074,2890,10,2830,60,3,1987,1170000
6762811106,6040,11,4100,1940,6,1996,1150000
6762811267,3600,9,2100,1500,4,1976,1080000
6762811339,3440,10,3440,0,4,1983,1050000
6762811340,3030,10,3030,0,4,1988,1050000
6762811341,3860,10,3860,0,4,2007,1050000
6762811481,4260,11,4260,0,4,1996,1000000
6762811815,2080,8,2080,0,4,1912,940000
6762811888,1660,8,1660,0,3,1907,926300
6762812001,3340,9,2240,1100,4,1963,910000
6762812454,3090,9,3090,0,4,1923,850000
6762812920,2410,8,1410,1000,4,1950,805000
6762813363,2350,8,2350,0,4,1987,770000
6762813703,2930,9,2930,0,4,1998,749000
6762814775,2000,7,1100,900,3,1916,677000
6762814968,2600,9,2600,0,4,1996,665000
6762815049,2450,8,2450,0,3,2010,660000
6762815124,2670,9,2670,0,3,1989,657500
6762815133,2740,8,1370,1370,4,1954,657000
6762815149,2860,10,2860,0,4,1999,655000
6762815369,2260,7,1130,1130,4,1947,648360
6762815559,3240,9,1860,1380,4,1977,635700
6762815755,2060,7,1350,710,3,1984,625000
6762815860,2980,9,2980,0,4,2000,622500
6762816235,2750,9,1720,1030,4,1981,604700
6762816279,1650,7,1040,610,3,1908,600000
6762816529,2170,8,1370,800,4,1968,592500
6762816670,3000,7,1500,1500,4,1950,585000
6762817452,2350,8,1430,920,4,1977,555000
6762818984,1670,8,1220,450,3,2002,505000
6762819033,2860,8,1510,1350,2,1948,503000
6762819417,1560,6,780,780,2,1904,494400
6762819437,1640,7,1640,0,4,1907,492000
6762819733,2230,8,1320,910,5,1978,482000
6762819765,3250,9,3250,0,4,1983,480000
6762819931,1820,8,1240,580,3,1981,475000
6762821591,1470,8,1090,380,3,2007,432000
6762821592,2200,6,1100,1100,3,1982,432000
6762821610,1900,8,1430,470,3,2008,431500
6762821638,3220,9,2450,770,4,1990,430000
6762821639,1520,8,1240,280,2,2007,430000
6762822564,1950,8,1950,0,3,2006,408000
6762822797,1040,7,1040,0,3,1942,400000
6762823027,590,5,590,0,2,1983,398000
6762823357,3140,9,3140,0,4,1991,389950
6762823462,1250,7,1250,0,3,1956,385000
6762823628,1230,7,1060,170,2,2011,380000
6762823629,2420,7,2420,0,5,2013,380000
6762823991,800,7,800,0,2,1918,373500
6762824052,3150,9,2250,900,4,1965,370000
6762824390,1100,6,1100,0,3,1922,361000
6762824533,1360,8,1360,0,3,2008,359000
6762824614,1060,7,1060,0,2,1977,356000
6762824635,1280,8,1280,0,3,2005,355000
6762824755,1060,7,1060,0,2,1979,353250
6762824757,550,7,550,0,1,2008,353000
6762825028,2052,8,2052,0,4,2014,349900
6762825059,1220,7,1220,0,3,1966,348580
6762825501,1070,7,1070,0,3,1951,337000
6762825754,2000,7,1300,700,5,1986,330000
6762825755,3150,7,3150,0,4,2005,330000
6762826171,1750,8,1750,0,3,1994,324000
6762826228,1347,7,1347,0,3,2010,321000
6762826244,1110,7,1110,0,3,1978,320000
6762826245,998,7,798,200,3,2007,320000
6762826351,1070,7,1070,0,2,1949,319950
6762826839,2320,7,2320,0,3,1976,307000
6762826889,2200,6,1400,800,4,1942,305000
6762827046,1860,7,1040,820,3,1954,301350
6762827066,2040,5,2040,0,6,1943,300000
6762827067,2760,8,2760,0,5,2006,300000
6762827352,980,7,980,0,4,1978,295000
6762828168,1170,7,880,290,1,1962,275000
6762828309,1990,7,1990,0,4,1990,273000
6762828382,840,7,840,0,2,2005,270000
6762828908,1550,7,1550,0,3,2011,259000
6762829095,2570,8,1720,850,4,1998,254500
6762829321,940,7,940,0,2,1959,249950
6762829460,1580,7,1040,540,4,1967,245000
6762829563,1980,7,1980,0,4,1988,243500
6762829620,1720,8,1720,0,4,1973,240000
6762829785,740,6,740,0,2,1938,235750
6762830333,910,6,910,0,3,1956,219900
6762831121,870,6,870,0,3,1969,180000
6762831122,1400,7,900,500,2,1922,180000
6762831123,1740,7,1020,720,4,1962,180000
6762831281,1160,7,1160,0,2,1998,168000
6762831423,820,7,820,0,2,1954,150000
6762810440,4390,11,3060,1330,4,1990,1610000
6762810747,3370,10,1860,1510,4,1988,1330000
6762811000,4740,11,4740,0,4,2003,1200000
6762811342,4380,11,4380,0,3,1983,1050000
6762811597,3680,10,2060,1620,4,1967,980000
6762811746,3400,10,3400,0,5,1999,950000
6762811802,2840,7,1420,1420,4,1952,945000
6762812048,2530,9,1570,960,4,1976,902000
6762812056,4080,10,4080,0,3,2000,900000
6762813023,4220,10,4220,0,4,1993,799950
6762813144,3500,9,3500,0,4,2005,788600
6762813196,2380,10,2380,0,4,1991,782000
6762813844,2390,9,2390,0,3,1984,735000
6762814797,2560,9,2560,0,4,1987,675000
6762814895,1590,7,1590,0,4,1951,670500
6762814969,1800,7,1320,480,3,1966,665000
6762815028,1240,7,1240,0,3,1926,662990
6762815035,2290,7,1690,600,4,1940,661254
6762815368,2250,8,1200,1050,4,1951,648475
6762815451,1620,7,940,680,3,1926,641000
6762815756,2600,9,2600,0,3,1984,625000
6762816162,1230,7,1230,0,3,1951,607000
6762816174,1500,7,1000,500,3,1947,606000
6762816407,1960,7,1410,550,3,1926,599000
6762816465,1030,7,830,200,2,1924,595000
6762816671,1670,8,1670,0,3,1931,585000
6762816783,1620,8,1470,150,3,2008,580000
6762817437,3840,11,3840,0,5,1991,556000
6762817501,3510,8,2210,1300,4,1965,554820
6762817544,1430,6,1080,350,3,1919,552000
6762817575,2510,9,2510,0,3,1992,550000
6762817576,1830,8,1830,0,3,1959,550000
6762817745,2830,8,2830,0,4,1987,549900
6762818113,2210,8,2210,0,3,1994,535000
6762818245,1814,7,944,870,4,1951,530000
6762818371,820,5,820,0,1,1999,527550
6762818389,1680,7,960,720,3,1992,526000
6762818722,1680,7,1140,540,2,1941,515000
6762819301,1140,6,1140,0,2,1924,498000
6762819875,1280,8,1280,0,3,1910,478000
6762820229,1620,7,1190,430,3,1973,467100
6762820261,2430,7,2430,0,4,1967,465425
6762820359,1120,7,1120,0,3,1925,464600
6762820407,1300,7,820,480,3,1919,462000
6762820435,1670,7,1170,500,3,1939,460000
6762820941,1560,7,1560,0,3,1923,449950
6762821056,1630,9,1630,0,3,1987,445000
6762821211,2560,7,1280,1280,4,1965,440000
6762821319,2380,7,2380,0,4,2002,439950
6762821566,1830,7,1010,820,4,1966,433000
6762822248,1110,7,1110,0,3,1963,416000
6762822456,1650,7,1650,0,3,1983,410000
6762822706,4060,9,2030,2030,4,1989,404000
6762822748,1540,8,1540,0,3,2005,402000
6762822982,2420,7,2420,0,3,1911,399500
6762823399,2440,8,2440,0,4,1993,388000
6762823564,1800,7,1200,600,3,1942,383000
6762823750,800,7,800,0,2,1940,379000
6762823793,2120,7,1320,800,5,1942,377691
6762823829,750,8,750,0,2,2006,375000
6762824408,1270,8,1270,0,3,2006,360000
6762824636,1220,8,1220,0,3,2007,355000
6762824726,1370,7,1370,0,3,1964,354800
6762824841,1010,7,1010,0,3,1947,350000
6762825556,1750,7,1240,510,4,1983,335000
6762825668,2210,8,1410,800,4,1965,334000
6762825998,1920,7,1120,800,3,1952,325000
6762826862,780,7,780,0,2,1946,306000
6762827068,1960,8,1960,0,4,2001,300000
6762827069,1340,7,1340,0,2,1947,300000
6762828169,1930,7,1930,0,4,1979,275000
6762828931,1620,7,1310,310,3,1988,258000
6762829009,1490,7,1490,0,3,1984,255000
6762829549,1450,6,1450,0,4,1943,244000
6762829792,1810,7,1230,580,4,1970,235000
6762829793,1140,8,1010,130,2,2007,235000
6762830128,1300,6,1300,0,2,1975,225000
6762830362,960,6,960,0,3,1982,218000
6762830781,1350,7,1350,0,4,1966,200000
6762831185,1300,6,1300,0,2,1958,175000
6762831449,1700,6,1700,0,3,1955,149000
6762831513,1080,7,1080,0,3,1967,132500
6762831601,580,5,580,0,2,1943,90000
6762831615,430,4,430,0,1,1912,80000
6762810219,4580,10,4580,0,5,2004,2000000
6762810392,5584,11,5584,0,4,1998,1680000
6762812773,3670,10,3670,0,4,2005,820000
6762819062,1010,7,1010,0,2,1924,501000
6762819326,1740,8,1740,0,3,1989,496700
6762819857,1370,7,1370,0,3,1924,479000
6762821201,2460,7,2460,0,3,2007,440500
6762824015,1960,7,1340,620,4,1979,372000
6762825093,2670,8,2670,0,4,1996,347000
6762829461,1260,7,1260,0,3,1994,245000
6762830863,720,6,720,0,2,1943,199000
6762814798,2980,10,1820,1160,3,1981,675000
6762824633,1620,7,1620,0,3,1955,355300
6762825999,2630,7,1640,990,4,1984,325000
6762827353,1560,7,1560,0,3,2003,295000
6762830912,1570,7,1570,0,3,1991,195000
6762812208,2130,8,2130,0,3,1989,880000
6762814543,2700,9,2700,0,4,2004,690000
6762820436,2730,8,1570,1160,2,1976,460000
6762823719,1690,7,1140,550,3,1956,379950
6762824053,1780,7,1780,0,3,2001,370000
6762825116,2100,8,2100,0,4,2009,346000
6762828140,1140,7,1140,0,3,1960,276000
6762831230,1140,7,1140,0,3,1972,172500
6762810312,4060,11,4060,0,4,2000,1800000
6762810360,4590,10,4590,0,5,2009,1710000
6762810406,3080,10,2300,780,4,1937,1660000
6762810447,3790,10,3790,0,3,1985,1600000
6762810487,3070,9,2400,670,4,1927,1570000
6762810683,3160,10,3160,0,4,1997,1380000
6762811107,5940,11,4950,990,4,2004,1150000
6762811206,2640,8,1750,890,3,1926,1100000
6762811343,2920,8,1470,1450,4,1921,1050000
6762811548,2510,8,1810,700,3,1932,994000
6762811653,3480,8,3480,0,5,1964,970000
6762811677,3250,8,2370,880,3,1951,967500
6762811702,3720,10,3720,0,5,2005,960000
6762811793,2290,9,2290,0,4,1978,949880
6762812408,3720,9,3720,0,4,1991,857000
6762812666,1850,8,1430,420,4,1978,830000
6762812966,2680,8,1380,1300,4,1952,800000
6762813213,2520,8,1560,960,3,1925,780000
6762813477,3330,9,3330,0,4,2009,760000
6762813566,2610,9,2610,0,3,2014,754950
6762813587,1880,8,1880,0,2,1902,751750
6762813845,3390,9,3390,0,5,2004,735000
6762813896,2330,9,1410,920,3,2004,732000
6762813907,1840,7,1010,830,3,1951,730001
6762813980,2740,10,2740,0,4,1990,725000
6762813981,2500,7,1450,1050,3,1940,725000
6762814152,2160,8,2160,0,2,2002,715000
6762814603,3000,8,1970,1030,4,1913,688000
6762814627,2810,9,2810,0,3,2001,685000
6762814799,2540,9,2540,0,3,1940,675000
6762815728,2710,8,1650,1060,3,2005,627000
6762816654,2370,7,2370,0,3,1979,587000
6762816672,1850,8,1850,0,3,1983,585000
6762817056,1930,8,1930,0,3,1977,570000
6762817121,4850,10,4850,0,5,2001,569950
6762817942,1960,7,1960,0,4,1940,540000
6762818114,1040,7,1040,0,2,1951,535000
6762818115,2340,7,2340,0,4,1921,535000
6762818342,1210,7,1210,0,3,1924,529000
6762818372,2310,8,1760,550,3,1977,527500
6762818414,2750,7,1750,1000,5,1926,525000
6762818723,3200,7,3200,0,4,2005,515000
6762819078,1760,8,1760,0,3,1988,500000
6762819230,1820,8,1430,390,3,2014,499950
6762819347,1940,7,1430,510,4,1956,495000
6762819348,1750,9,1750,0,3,2013,495000
6762819586,1590,7,1590,0,3,1985,488000
6762819766,1150,7,1150,0,3,1943,480000
6762819893,1720,8,1720,0,4,1978,477000
6762819932,1230,7,1230,0,3,1984,475000
6762819933,3400,8,2500,900,4,1991,475000
6762820209,1160,7,860,300,2,1942,468000
6762820268,1560,7,1560,0,3,1967,465000
6762820437,1600,8,1240,360,3,2006,460000
6762820566,1840,7,1050,790,3,1925,457500
6762820602,2420,7,2420,0,3,1998,455600
6762820603,1460,7,1460,0,3,1975,455500
6762820762,2510,9,2510,0,4,2009,450800
6762820774,2520,7,2520,0,4,1999,450000
6762821044,1870,8,1870,0,3,2003,445830
6762821372,1650,7,1650,0,3,1961,438000
6762821447,1270,7,1270,0,3,1928,435000
6762821799,920,6,920,0,2,1910,427000
6762822273,1950,7,1350,600,3,1964,415000
6762822274,1900,7,1130,770,5,1961,415000
6762822626,1980,7,1310,670,3,1949,405000
6762822627,910,7,910,0,2,1942,405000
6762822798,1470,7,1470,0,2,1940,400000
6762822939,1296,8,1296,0,3,2009,399950
6762822989,2870,8,2540,330,4,1979,399000
6762823374,2330,7,1190,1140,5,1962,389000
6762823830,1440,7,1440,0,3,1973,375000
6762823831,2000,7,1520,480,3,1965,375000
6762824054,1280,7,1080,200,2,2009,370000
6762824409,1050,7,1050,0,3,1954,360000
6762824410,1570,7,1570,0,3,1954,360000
6762824637,1810,7,1810,0,4,2003,355000
6762825136,1180,7,990,190,2,2005,345000
6762825221,2330,7,1400,930,4,1941,344950
6762825756,1360,7,1360,0,4,1955,330000
6762825906,1600,7,1150,450,3,1964,329000
6762825970,1810,7,1810,0,3,1970,326500
6762825974,880,6,880,0,2,1942,326100
6762826000,1780,9,1780,0,3,1983,325000
6762826608,1320,7,1320,0,3,1948,313000
6762826615,1630,7,1630,0,4,2003,312900
6762826633,1255,7,1255,0,3,2004,312000
6762826890,2100,7,1050,1050,4,1968,305000
6762826987,900,7,900,0,3,1972,304000
6762827340,1410,7,960,450,5,1955,295832
6762827457,3250,9,3250,0,4,1973,293000
6762827480,2840,7,1710,1130,5,2003,292050
6762827859,1982,8,1982,0,4,2004,283200
6762827879,1680,7,1240,440,3,1994,282000
6762827922,1200,6,920,280,3,1943,280000
6762828276,1670,7,1320,350,3,1987,274950
6762828531,1930,7,1030,900,4,1967,268000
6762828610,1440,7,1000,440,3,1983,265000
6762828723,1658,8,1658,0,3,2014,263900
6762828796,1630,7,1630,0,3,2003,260000
6762829010,960,7,960,0,3,1955,255000
6762829550,910,6,910,0,3,1971,244000
6762830782,1720,7,1120,600,4,1961,200000
6762831339,1180,6,1180,0,2,1918,160000
6762810220,4260,11,4260,0,4,2000,2000000
6762810234,4440,10,3140,1300,8,1959,1970000
6762810639,2980,10,2140,840,4,1900,1400000
6762810640,4700,11,2520,2180,4,2005,1400000
6762810829,3240,10,2260,980,4,1946,1290000
6762810979,3650,9,2530,1120,4,1951,1210000
6762811059,1970,8,1100,870,3,1937,1180000
6762811207,2050,8,2050,0,2,1950,1100000
6762811513,3150,9,3150,0,7,1957,999000
6762811674,3610,9,2070,1540,6,1959,968000
6762811703,2410,9,1800,610,4,1929,960000
6762811895,2690,7,1840,850,3,1943,925000
6762812057,2300,9,2300,0,6,1950,900000
6762812107,2680,8,1450,1230,5,1963,898000
6762812243,2280,7,1280,1000,3,1917,875000
6762812562,2520,8,1410,1110,3,1906,840500
6762812566,3040,9,2100,940,4,1906,840000
6762812567,3420,10,3420,0,4,2000,840000
6762812568,2330,8,1300,1030,4,1924,840000
6762812774,2510,9,2510,0,3,1995,820000
6762812818,2000,8,2000,0,4,2001,815000
6762813035,2580,8,2580,0,4,1984,799000
6762813197,3910,9,3130,780,4,2007,782000
6762813729,1490,7,1140,350,3,1947,745000
6762813769,2080,7,1080,1000,2,1923,740000
6762813770,2920,9,2920,0,4,1998,740000
6762813813,2810,9,2810,0,3,2005,739000
6762814346,2320,8,1720,600,2,1925,700000
6762814347,4490,9,3390,1100,4,2006,700000
6762814687,3150,9,3150,0,4,2006,681716
6762814689,1700,7,1700,0,3,1907,681000
6762814970,2190,9,2190,0,3,1987,665000
6762815150,2990,8,2990,0,4,2003,655000
6762815566,2300,8,2000,300,3,1921,635000
6762815658,2740,9,2740,0,4,1993,630000
6762815875,2180,9,2180,0,3,1986,621138
6762816280,2510,9,2510,0,4,1960,600000
6762816281,1580,7,1150,430,3,1967,600000
6762816408,2020,8,1010,1010,4,1917,599000
6762816549,1650,7,1650,0,3,1926,590000
6762816616,1110,7,1110,0,3,1932,589000
6762816784,1940,7,970,970,5,1945,580000
6762817186,4140,7,2070,2070,7,1978,565000
6762817453,3160,8,2650,510,3,2006,555000
6762817577,1660,5,930,730,4,1933,550000
6762817884,2230,7,1450,780,4,1974,544500
6762818072,1550,7,1550,0,3,1999,537000
6762818116,1720,8,1720,0,3,1994,535000
6762818724,2680,8,2680,0,4,2004,515000
6762818845,1400,7,870,530,3,1951,510250
6762818848,2040,7,1020,1020,4,1961,510000
6762819231,2798,9,2798,0,4,2012,499950
6762819470,2360,8,2360,0,4,2003,490000
6762819850,1980,9,1980,0,3,1994,479900
6762820051,1400,8,1400,0,2,2000,474800
6762820269,4250,10,2150,2100,6,1967,465000
6762820270,1840,7,1840,0,3,2003,465000
6762820438,2230,8,2230,0,4,1991,460000
6762820775,1100,7,1100,0,3,1917,450000
6762821365,1610,7,1610,0,3,1947,438750
6762821576,1980,7,1270,710,3,1965,432500
6762821640,3890,8,2390,1500,3,1943,430000
6762821745,1350,8,1350,0,2,2005,429000
6762821838,1680,7,1080,600,4,1979,425000
6762822060,1820,7,1250,570,3,1977,420000
6762823101,2250,7,2250,0,3,2006,395000
6762823630,1660,7,1660,0,3,1949,380000
6762824055,800,6,800,0,3,1908,370000
6762824056,3090,9,3090,0,4,1995,370000
6762824249,1300,7,1300,0,3,1963,365000
6762824348,3753,10,3336,417,4,2008,363000
6762824638,1270,7,960,310,2,1920,355000
6762824639,2400,9,2400,0,3,1990,355000
6762825137,1080,7,1080,0,2,1940,345000
6762825557,1480,6,740,740,4,1910,335000
6762825976,1720,7,1720,0,3,1958,326000
6762826001,1050,7,1050,0,2,2005,325000
6762826465,1300,7,900,400,3,1993,315000
6762826679,1430,7,1430,0,3,1927,310000
6762826863,1680,8,1680,0,3,1984,306000
6762826891,1160,7,1160,0,3,1968,305000
6762827249,1390,7,1390,0,3,1954,299000
6762827755,800,6,800,0,2,1954,285000
6762828122,1450,6,990,460,4,1964,277000
6762828383,1430,6,1430,0,3,1953,270000
6762828384,1300,6,650,650,3,1918,270000
6762828568,2495,8,2495,0,3,2007,267000
6762828589,1430,7,1430,0,3,1966,266200
6762829099,1060,6,1060,0,2,1952,254000
6762829100,1480,7,1480,0,3,1992,254000
6762829117,1400,7,1400,0,3,1968,253400
6762829452,1300,7,1300,0,3,1996,245100
6762829545,2060,7,2060,0,3,1999,244615
6762829586,1310,7,1310,0,3,1979,242000
6762829776,1830,7,1200,630,4,1989,236000
6762830129,2030,7,1220,810,3,1979,225000
6762830130,1680,8,1680,0,3,1994,225000
6762830209,1560,7,1040,520,3,1964,224000
6762830266,1180,7,1180,0,3,1946,220000
6762830417,1320,6,1320,0,2,1943,215000
6762830418,1210,6,1210,0,3,1983,215000
6762830536,880,7,880,0,2,2007,210000
6762831024,1700,5,850,850,2,1927,189000
6762831047,1390,7,1390,0,2,1986,186950
6762831186,830,7,830,0,2,1996,175000
6762831279,1100,7,1100,0,3,1969,168500
6762831375,740,5,740,0,2,1949,157500
6762831419,720,5,720,0,2,1942,151000
6762831424,820,6,820,0,3,1910,150000
6762831497,780,5,780,0,2,1948,135000
6762831538,1340,6,1340,0,3,1978,124740
6762810059,6980,12,5330,1650,6,1999,3100000
6762810088,4430,10,4430,0,4,1952,2750000
6762810130,4730,10,4270,460,4,1935,2450000
6762810616,4960,11,3680,1280,4,1909,1430000
6762810704,5960,10,4770,1190,5,1984,1360000
6762811747,4140,11,4140,0,4,2000,950000
6762812373,2770,10,2770,0,3,1991,860000
6762812775,2280,8,1960,320,4,1940,820000
6762813107,2900,8,1890,1010,5,1967,790000
6762813597,2170,8,1450,720,5,1911,750500
6762814049,1960,8,1290,670,4,1959,723000
6762814486,2390,9,2390,0,3,2006,695000
6762814544,2920,9,2920,0,4,1990,690000
6762814628,1940,8,1440,500,3,1960,685000
6762814693,2330,7,1520,810,3,1927,680000
6762814875,2620,9,2620,0,4,2000,672500
6762814883,2620,7,2620,0,3,1992,672000
6762815120,3310,9,3310,0,4,2008,658000
6762815220,2930,9,2930,0,3,2008,650880
6762815393,1730,9,1320,410,3,2008,645000
6762815562,1640,7,920,720,4,1921,635200
6762815948,2300,8,1550,750,4,1915,619000
6762816252,2760,9,2760,0,4,1999,602500
6762816282,2930,9,2030,900,3,1993,600000
6762816466,1480,7,750,730,3,1928,595000
6762817187,2440,8,2440,0,4,1996,565000
6762817578,2450,7,1240,1210,5,1900,550000
6762817943,2600,7,1400,1200,3,1940,540000
6762818117,1360,7,1310,50,3,2003,535000
6762818343,1590,7,1590,0,3,1944,529000
6762818415,2630,8,2630,0,5,2003,525000
6762818416,2600,9,1890,710,3,1989,525000
6762818849,2240,8,1370,870,3,1929,510000
6762819034,2590,8,1980,610,3,1988,503000
6762819626,1600,7,1600,0,4,1916,485000
6762819920,2110,7,1110,1000,3,1924,475300
6762820080,4410,9,2350,2060,6,1965,472000
6762820726,2590,8,1340,1250,4,1968,452000
6762820776,2240,7,1120,1120,4,1956,450000
6762820942,2320,8,2320,0,4,2012,449950
6762821057,1990,7,1190,800,4,1944,445000
6762821419,1260,7,1040,220,2,1951,436500
6762822414,1950,8,1950,0,3,1985,412000
6762822628,1240,7,1240,0,3,1988,405000
6762822629,1880,7,960,920,5,1963,405000
6762822749,710,7,710,0,2,1943,402000
6762822799,1390,7,1140,250,4,1965,400000
6762822800,1240,7,800,440,4,1987,400000
6762822801,1930,7,1020,910,5,1962,400000
6762822802,1670,7,1670,0,4,1955,400000
6762823102,1320,6,1320,0,2,1909,395000
6762823375,910,7,910,0,2,1952,389000
6762824203,810,6,810,0,2,1919,367500
6762824842,2040,7,2040,0,4,2011,350000
6762825044,1700,7,1120,580,4,1981,349000
6762825717,2270,7,1380,890,3,1977,332000
6762825887,1460,7,1100,360,3,1971,329932
6762826892,1000,8,1000,0,2,2006,305000
6762827028,900,6,900,0,2,1925,302000
6762827070,820,6,820,0,2,1916,300000
6762827071,2080,8,2080,0,3,1989,300000
6762827354,2290,7,2290,0,4,2001,295000
6762828554,1590,7,1090,500,3,1957,267500
6762828586,1880,7,1180,700,4,1978,266500
6762828700,1720,7,1120,600,4,1978,264950
6762828716,1470,7,1470,0,3,1958,264000
6762828757,1500,5,880,620,2,1928,262000
6762829197,1110,6,1110,0,2,1951,250000
6762829429,1270,7,1270,0,3,1964,246500
6762829934,1530,7,1530,0,4,1942,231000
6762829948,950,6,950,0,2,1958,230000
6762830537,1590,7,1590,0,3,1986,210000
6762831391,1250,7,1030,220,3,1949,155000
6762831466,1010,6,1010,0,3,1954,145000
6762831611,900,5,900,0,2,1918,83000
6762810035,5550,12,3350,2200,4,2000,3710000
6762810136,4140,10,3300,840,4,1977,2400000
6762810275,4180,11,4180,0,5,2004,1890000
6762810666,5700,10,2850,2850,6,1977,1390000
6762810698,2090,9,2090,0,3,1928,1370000
6762810877,3150,9,3150,0,4,1966,1260000
6762811748,2500,8,1500,1000,4,1970,950000
6762811966,3760,9,2860,900,4,2014,919204
6762812374,3060,10,3060,0,3,1983,860000
6762812569,4290,10,4290,0,7,1982,840000
6762812710,2780,9,2780,0,3,2009,825500
6762812967,1730,7,1730,0,2,1947,800000
6762813603,1700,8,1460,240,3,1947,750000
6762813604,2600,8,1560,1040,4,1976,750000
6762813771,3990,8,3090,900,5,1937,740000
6762813846,2840,8,2060,780,4,1931,735000
6762814153,3420,8,1770,1650,4,1947,715000
6762814348,2310,7,1490,820,4,1927,700000
6762814629,2310,9,2310,0,4,2013,685000
6762815105,3190,8,2210,980,4,1946,659000
6762815151,2060,8,1440,620,4,1983,655000
6762815230,1740,8,1210,530,2,1994,650000
6762815388,1890,7,1890,0,2,1909,645500
6762815444,2670,10,2670,0,3,1987,642000
6762815445,2560,9,2560,0,4,1992,642000
6762815757,4240,10,3550,690,4,1989,625000
6762817147,2340,7,1170,1170,4,1966,568000
6762817320,2000,8,2000,0,3,1953,560000
6762817819,2720,8,2720,0,4,2012,545000
6762818246,1950,8,1950,0,3,1988,530000
6762819259,2620,8,2620,0,4,2013,499431
6762819471,1920,7,960,960,3,1947,490000
6762819565,2260,9,2260,0,3,1994,489000
6762819934,1540,7,1540,0,2,1983,475000
6762820271,1820,8,1340,480,4,1977,465000
6762820518,2580,7,1290,1290,3,1951,459900
6762820555,3090,8,2990,100,5,1957,458000
6762821800,2220,7,1230,990,5,1973,427000
6762821839,1680,6,840,840,3,1900,425000
6762821840,1510,7,1240,270,3,1989,425000
6762821841,1820,7,1260,560,3,1974,425000
6762822275,1340,8,1340,0,2,2004,415000
6762822990,940,6,940,0,2,1911,399000
6762823103,2910,8,2910,0,4,2002,395000
6762823441,2120,9,2120,0,3,1991,386000
6762823463,1220,6,1220,0,3,1901,385000
6762823541,1860,7,1860,0,3,2000,384950
6762823981,1200,7,1200,0,3,1971,374000
6762824161,1550,7,1150,400,3,1959,369000
6762824243,1490,7,1490,0,3,2009,365250
6762824608,1090,7,730,360,2,1942,356700
6762825029,2200,8,2200,0,3,1990,349900
6762825718,1000,6,1000,0,2,1942,332000
6762825757,1240,7,1240,0,2,2007,330000
6762826002,2180,7,1090,1090,3,1961,325000
6762826211,2280,8,2280,0,4,1994,322000
6762826466,1060,7,1060,0,3,1981,315000
6762827199,1210,7,1210,0,3,1955,299950
6762827923,1880,6,940,940,2,1919,280000
6762828797,1050,7,1050,0,3,1980,260000
6762829322,1290,7,1290,0,4,1957,249950
6762829621,1330,7,630,700,3,1900,240000
6762830899,1560,6,1560,0,3,1992,196440
6762830980,1590,7,1090,500,3,1978,190000
6762831282,1220,8,1220,0,2,1976,168000
6762814520,2460,9,2460,0,3,1996,693000
6762815050,2675,8,2675,0,3,1984,660000
6762815991,1760,9,1760,0,3,2014,615000
6762816655,2550,9,2550,0,4,1992,587000
6762818052,2080,8,2080,0,5,1987,538888
6762827617,1960,7,1960,0,3,2004,289950
6762810448,3640,10,2540,1100,5,1982,1600000
6762810531,3480,9,2580,900,4,1926,1510000
6762812553,2630,8,2630,0,4,1953,843500
6762815051,2780,10,2780,0,4,1978,660000
6762820526,1620,7,1090,530,3,1974,459000
6762829198,750,6,750,0,1,1918,250000
6762829570,1790,7,1040,750,3,1960,243000
6762810235,4370,10,3610,760,4,2003,1970000
6762810890,3160,8,3160,0,5,1972,1250000
6762811391,2230,9,2230,0,3,2003,1040000
6762811482,2730,9,2730,0,3,1998,1000000
6762811583,1670,8,1670,0,3,1912,985000
6762811682,2460,8,1620,840,4,1938,965000
6762811729,3020,10,2720,300,3,1969,955000
6762811827,3270,9,3270,0,4,2014,939000
6762812295,4500,9,3040,1460,4,1980,870000
6762812776,2160,8,1390,770,3,1960,820000
6762812900,1840,8,1840,0,4,1917,809000
6762812954,2210,8,2210,0,2,2003,802000
6762813143,3740,10,3740,0,3,1991,789000
6762813909,2360,7,1260,1100,4,1939,730000
6762813975,3190,9,3190,0,4,2001,725995
6762814616,4400,9,4400,0,4,1993,687000
6762814619,1840,8,1840,0,3,1961,686000
6762814800,2610,9,2610,0,3,1988,675000
6762814941,2710,9,2710,0,4,1999,668500
6762814971,2720,10,2720,0,4,1987,665000
6762815036,1990,8,1420,570,4,1932,661000
6762815192,2290,9,2290,0,3,2006,653000
6762815394,2430,8,1670,760,4,1963,645000
6762815567,1960,8,980,980,3,1940,635000
6762815708,1760,7,960,800,3,1920,629000
6762815992,2150,8,2150,0,4,1985,615000
6762816086,3990,8,1990,2000,5,1962,610000
6762816666,2910,8,1590,1320,5,1977,585083
6762816785,2220,8,2220,0,4,1988,580000
6762817142,2180,7,1310,870,3,1981,568500
6762817397,2930,9,1860,1070,3,2004,559900
6762817579,1810,7,1810,0,3,1925,550000
6762817580,1840,7,920,920,3,1926,550000
6762817887,1790,7,1790,0,3,1910,544000
6762817944,1720,7,1460,260,4,1925,540000
6762818118,1690,8,1690,0,3,1984,535000
6762818417,2910,9,2910,0,4,2006,525000
6762819079,1720,7,960,760,3,1941,500000
6762819438,2770,8,1580,1190,3,1978,492000
6762820073,1750,7,1490,260,3,1982,472500
6762820191,950,6,950,0,3,1948,469000
6762820260,1890,7,1290,600,3,1965,465500
6762820608,1170,7,970,200,2,1941,455000
6762820609,1140,7,850,290,2,1947,455000
6762821204,1110,7,1000,110,2,1947,440150
6762821212,2340,8,1720,620,4,1967,440000
6762821329,1410,8,1410,0,2,1909,439900
6762821332,1120,7,1120,0,3,1956,439800
6762821577,2240,7,2240,0,3,2002,432500
6762821641,990,7,990,0,2,1947,430000
6762822439,2150,8,1240,910,4,1976,411000
6762822457,1790,7,1490,300,4,1969,410000
6762822630,1710,7,1330,380,2,1920,405000
6762822707,2030,7,1330,700,3,1963,404000
6762822803,1495,8,1405,90,3,2006,400000
6762823104,730,7,730,0,1,1911,395000
6762823237,1410,7,1290,120,3,2004,391000
6762823631,1210,8,1060,150,2,1950,380000
6762824227,1510,7,1510,0,3,1967,366000
6762824843,2680,8,2680,0,3,1990,350000
6762825138,1990,7,1320,670,3,1963,345000
6762825274,1175,8,740,435,2,2005,342000
6762825954,1320,7,1320,0,3,1970,327000
6762826246,3020,8,1510,1510,5,1978,320000
6762826440,2130,8,1570,560,3,1987,316000
6762826467,960,6,960,0,3,1952,315000
6762826893,1140,7,1140,0,2,1988,305000
6762826894,950,7,950,0,3,1950,305000
6762827072,2070,8,2070,0,4,2003,300000
6762827304,1950,7,1950,0,3,2010,298000
6762827531,2080,8,2080,0,3,2002,290000
6762827756,1380,7,1140,240,2,2011,285000
6762828170,1380,7,1380,0,3,2008,275000
6762828277,1450,6,1050,400,3,1958,274950
6762828385,1920,8,1920,0,4,1998,270000
6762829199,1850,7,1540,310,4,1978,250000
6762830839,1010,7,1010,0,3,1969,199950
6762831392,720,6,720,0,1,1940,155000
6762810796,2790,8,2790,0,4,1985,1300000
6762811208,2930,9,2130,800,4,1925,1100000
6762811209,2580,9,1300,1280,4,1950,1100000
6762811295,4130,11,4130,0,4,2001,1070000
6762811622,2290,9,2120,170,4,1958,975000
6762811704,3040,10,3040,0,5,1993,960000
6762811705,4590,10,3490,1100,4,1981,960000
6762811812,3490,9,2460,1030,5,1980,941500
6762811869,2200,8,1430,770,4,1908,930000
6762811870,2680,9,2680,0,2,2006,930000
6762812244,3720,8,1860,1860,4,1970,875000
6762812455,1370,7,770,600,3,1911,850000
6762812531,2550,9,2550,0,5,1905,847000
6762812616,1550,9,1550,0,4,1930,835000
6762812667,2080,9,2080,0,3,2004,830000
6762813156,1840,8,1540,300,3,1910,785200
6762813364,2430,10,2430,0,3,1987,770000
6762814073,2870,9,2870,0,4,1986,720000
6762814122,1030,7,1030,0,3,1952,718000
6762814197,2050,7,2050,0,3,1951,713250
6762814202,1660,7,1660,0,3,1956,712500
6762814226,2140,8,1070,1070,3,1928,710000
6762814487,2961,9,2961,0,4,1998,695000
6762814587,2390,8,1390,1000,3,1942,689800
6762815052,2290,9,2290,0,3,1953,660000
6762815179,2790,9,2790,0,4,1987,654950
6762815231,2550,8,2550,0,5,1902,650000
6762815465,2370,9,2370,0,3,1993,640000
6762816052,1350,7,1350,0,3,1991,613000
6762816053,2070,7,1340,730,5,1967,613000
6762816184,2740,7,1670,1070,5,1925,605000
6762816185,2060,8,1120,940,3,1947,605000
6762816283,2620,8,2620,0,4,1987,600000
6762816284,1960,8,1290,670,4,1958,600000
6762816550,2360,8,2360,0,4,1939,590000
6762816777,3150,8,3150,0,4,2014,580135
6762816924,3800,10,3330,470,3,1976,575000
6762816925,3120,10,3120,0,4,2010,575000
6762817040,1300,6,1300,0,3,1952,571500
6762817286,2090,8,2090,0,3,1983,562100
6762817321,2000,7,1400,600,3,1963,560000
6762817581,2170,7,1460,710,4,1980,550000
6762817779,2110,8,2110,0,3,2001,548000
6762817820,1810,7,1810,0,3,1903,545000
6762818247,1250,7,1250,0,3,1942,530000
6762819035,2190,9,2190,0,3,1999,503000
6762819080,1620,7,830,790,3,1945,500000
6762819349,2220,8,1110,1110,4,1961,495000
6762819412,2670,8,2670,0,5,2014,494995
6762819935,2600,8,2600,0,3,1989,475000
6762820049,1800,8,1800,0,3,1976,474900
6762820098,3030,8,2020,1010,4,1998,471000
6762820962,2040,7,1200,840,5,1969,449500
6762821213,1230,7,1130,100,2,1906,440000
6762821214,1680,8,1680,0,3,1989,440000
6762821405,2120,7,2120,0,5,1913,437000
6762821448,2220,7,1110,1110,3,1988,435000
6762821593,1970,7,1970,0,3,2003,432000
6762821642,1360,6,910,450,3,1924,430000
6762821643,1790,7,1110,680,4,1973,430000
6762821784,2340,8,2340,0,3,2013,427874
6762821842,1660,7,1110,550,3,1979,425000
6762821843,1870,7,1440,430,3,1978,425000
6762821844,1140,8,1140,0,2,2007,425000
6762822061,1660,8,1380,280,3,1981,420000
6762822539,1370,6,1370,0,2,1944,409950
6762822735,2780,8,2780,0,3,2009,402500
6762822804,1200,7,1200,0,3,1962,400000
6762822805,1450,7,1450,0,3,2009,400000
6762823249,1080,7,1080,0,3,1947,390000
6762823819,2550,8,1750,800,6,1958,375900
6762824250,1720,7,1720,0,3,1990,365000
6762824344,2240,8,2240,0,4,2014,363990
6762825924,1950,9,1950,0,3,1990,328500
6762826003,2250,8,2250,0,3,1980,325000
6762826247,1880,6,940,940,3,1952,320000
6762826248,1530,8,1140,390,3,2013,320000
6762826468,2090,7,2090,0,5,1998,315000
6762826634,1830,7,1830,0,4,2003,312000
6762826635,1540,7,770,770,3,1954,312000
6762826794,2481,8,2481,0,5,2014,309000
6762827355,1170,7,1170,0,2,1963,295000
6762827757,2880,8,1580,1300,3,1958,285000
6762827924,1480,7,1480,0,2,1940,280000
6762827925,1590,6,1590,0,3,1926,280000
6762828324,1410,7,1410,0,3,1983,272500
6762828532,1970,8,1970,0,3,1966,268000
6762829122,1220,7,860,360,2,1921,253000
6762829200,1765,7,1765,0,3,1996,250000
6762829719,1340,7,1340,0,3,1968,239000
6762829720,1040,6,1040,0,3,1942,239000
6762829794,1530,7,1530,0,3,1970,235000
6762829795,720,6,720,0,2,1947,235000
6762829796,1250,7,1250,0,3,1959,235000
6762829883,940,5,940,0,2,1952,234000
6762829949,1440,6,720,720,3,1942,230000
6762830131,1200,6,1200,0,3,1969,225000
6762830221,1030,7,1030,0,3,1961,223000
6762830234,1200,7,1200,0,3,1995,222400
6762830538,1110,7,1110,0,3,1962,210000
6762830666,1060,6,1060,0,3,1962,206000
6762830954,1180,7,1180,0,3,1960,193000
6762831222,1240,7,1240,0,2,1986,174500
6762831425,1320,7,1320,0,3,1959,150000
6762810137,3410,9,2760,650,5,1912,2400000
6762810217,3810,10,3810,0,6,1969,2010000
6762810261,2660,10,2660,0,3,1992,1900000
6762810862,3200,7,2160,1040,5,1952,1270000
6762811160,3880,9,2540,1340,5,1979,1130000
6762811210,2660,8,1470,1190,5,1969,1100000
6762811414,2640,9,1320,1320,3,1960,1030000
6762811570,3280,9,2440,840,5,2003,989000
6762812025,2770,9,2770,0,4,1987,907500
6762812245,3790,10,3790,0,4,1999,875000
6762812332,2090,7,1610,480,3,1947,865000
6762812375,4720,10,3190,1530,3,1998,860000
6762812609,2700,8,2700,0,4,1994,837500
6762813101,2430,8,1810,620,3,1989,791000
6762813161,1670,8,1670,0,3,1961,785000
6762813408,1630,10,1630,0,3,2006,767450
6762813416,4410,9,3400,1010,4,2006,765000
6762813471,1990,7,1130,860,3,1912,760500
6762813478,2730,9,2730,0,4,1986,760000
6762813479,3370,10,3370,0,4,1991,760000
6762813531,1540,7,1540,0,4,1923,759600
6762813725,2370,8,1650,720,3,1973,746000
6762813761,1540,9,1540,0,3,2011,742000
6762814630,2770,9,2770,0,4,1989,685000
6762815116,2560,10,2560,0,3,1986,658588
6762815370,3290,9,3290,0,4,2008,648000
6762815384,2500,8,1600,900,4,1978,646000
6762815466,1690,8,1690,0,3,2007,640000
6762816087,2910,9,2910,0,4,2012,610000
6762816243,4060,9,2150,1910,4,1977,603500
6762816660,1780,8,1600,180,3,2006,586500
6762816749,2630,8,1650,980,6,1974,583000
6762817029,1830,8,1290,540,3,1986,572000
6762817188,2650,7,1400,1250,5,1961,565000
6762817322,2070,8,2070,0,3,1996,560000
6762817757,2740,7,2740,0,4,1991,549000
6762817821,2730,7,1660,1070,5,1958,545000
6762817945,1050,7,1050,0,3,1925,540000
6762818032,1710,8,1570,140,3,2005,539000
6762818219,1820,8,1820,0,3,1993,532000
6762818220,2020,7,1430,590,4,1979,532000
6762818418,1540,8,1540,0,3,2004,525000
6762818594,1540,8,1540,0,3,2011,520000
6762818654,830,7,830,0,2,1920,519000
6762819081,2920,8,2920,0,5,2003,500000
6762819232,1520,8,1040,480,3,2007,499950
6762819566,1020,7,920,100,3,1930,489000
6762819627,2340,8,2340,0,3,1985,485000
6762820116,1800,7,1800,0,3,1956,470000
6762820272,910,7,910,0,3,1948,465000
6762820610,1420,8,1420,0,3,2006,455000
6762820692,2300,7,1170,1130,5,1967,453500
6762821406,1500,7,910,590,2,1942,437000
6762821787,2460,9,2460,0,4,2003,427500
6762822197,2060,7,2060,0,3,2007,418500
6762822276,2000,8,2000,0,4,1999,415000
6762822432,1840,7,1040,800,3,1952,411715
6762822806,1530,7,1530,0,3,1986,400000
6762822807,2260,7,1130,1130,3,1986,400000
6762822940,2080,7,1190,890,3,1959,399950
6762823205,2150,8,2150,0,4,2005,392500
6762823250,1250,7,1250,0,3,1942,390000
6762823251,1240,7,1240,0,3,1952,390000
6762823832,2200,7,1100,1100,4,1955,375000
6762823833,820,5,820,0,2,1922,375000
6762824033,1420,7,1420,0,3,1959,371000
6762824251,1250,7,1250,0,2,1947,365000
6762824324,2310,7,2310,0,4,1978,364950
6762824640,1650,7,950,700,2,1947,355000
6762825316,2190,8,2190,0,3,1978,340000
6762825558,2540,7,1600,940,4,1979,335000
6762825945,1070,7,1070,0,3,1989,327500
6762825946,1650,8,1650,0,4,1968,327500
6762826140,1210,7,1210,0,3,1949,324950
6762826249,1650,7,1130,520,3,1978,320000
6762826420,1010,6,1010,0,3,1959,317000
6762826680,1350,7,1110,240,3,1995,310000
6762827250,560,4,560,0,1,1967,299000
6762827481,1730,7,1730,0,3,1972,292000
6762827618,1670,8,1670,0,3,1992,289950
6762827758,2437,7,2437,0,3,2011,285000
6762827926,960,6,960,0,2,1942,280000
6762828171,1720,8,1000,720,3,1983,275000
6762828172,770,6,770,0,2,1948,275000
6762828386,2080,7,1550,530,3,2003,270000
6762828776,1810,7,950,860,3,1983,261000
6762829186,1710,7,1710,0,3,1988,250500
6762829201,2120,7,2120,0,4,1960,250000
6762829615,1460,7,990,470,3,1997,240500
6762830046,1770,8,1770,0,3,1968,229500
6762830319,1500,7,1150,350,3,1984,219950
6762830499,920,7,920,0,3,1977,212500
6762830783,2060,6,2060,0,3,1903,200000
6762830981,1750,5,1750,0,5,1943,190000
6762831187,670,5,670,0,2,1919,175000
6762831243,1500,8,1500,0,2,1950,170000
6762831332,1720,7,1220,500,4,1974,161700
6762831498,790,6,790,0,1,1942,135000
6762831524,650,5,650,0,1,1967,129000
6762831554,1170,6,1170,0,3,1980,119500
6762810313,4400,11,3390,1010,5,2003,1800000
6762810624,4670,12,4670,0,4,1989,1420000
6762810797,3902,9,2782,1120,6,1977,1300000
6762811087,2980,10,2020,960,4,1935,1160000
6762811268,5180,11,4070,1110,5,2001,1080000
6762811730,5660,10,4100,1560,4,2001,955000
6762812181,2660,7,1480,1180,4,1923,886000
6762812246,3250,10,2500,750,3,2001,875000
6762812247,2920,8,2320,600,5,1906,875000
6762813036,3500,9,2500,1000,4,1994,799000
6762813054,3590,10,3590,0,3,1999,798000
6762813067,2070,8,1700,370,4,1967,795000
6762813691,3110,9,3110,0,4,1983,749950
6762813704,2670,9,2670,0,3,1987,749000
6762813982,2420,8,1530,890,4,1977,725000
6762814349,1910,7,1080,830,3,1959,700000
6762814350,2050,9,2050,0,3,2011,700000
6762814631,3150,9,3000,150,3,1990,685000
6762815193,2680,8,1610,1070,3,1979,653000
6762815379,1290,7,1290,0,3,1916,647500
6762815467,2340,7,1170,1170,3,1917,640000
6762815659,4610,10,2500,2110,4,1980,630000
6762815887,2400,7,1460,940,4,1929,620000
6762815949,1660,7,1660,0,4,1926,619000
6762816088,1830,8,1230,600,4,1990,610000
6762816181,1370,9,1370,0,4,1951,605004
6762816741,1480,8,1280,200,3,2007,584000
6762817189,2390,8,1360,1030,3,1977,565000
6762817257,1980,7,1090,890,3,1910,564000
6762817323,2260,9,2260,0,4,2003,560000
6762817454,2020,8,1420,600,4,1976,555000
6762817582,2700,9,2700,0,4,2007,550000
6762817792,1480,7,1480,0,3,1968,547000
6762817806,970,7,970,0,2,1924,546000
6762817822,1700,6,1700,0,3,1931,545000
6762817946,1330,8,1330,0,4,1962,540000
6762818248,2210,8,2210,0,4,1968,530000
6762818249,4160,8,2760,1400,4,1973,530000
6762818328,1710,8,1300,410,3,2003,529999
6762819233,2370,7,2370,0,3,2001,499950
6762819257,2520,7,2520,0,3,1988,499500
6762819266,1690,7,1360,330,3,2008,499000
6762819350,2440,9,1450,990,5,2006,495000
6762819439,2810,8,2070,740,4,1994,492000
6762820248,1480,7,1480,0,3,1996,466800
6762820250,1430,7,950,480,3,1945,466500
6762820273,1530,9,1050,480,3,2014,465000
6762820384,1640,7,1640,0,3,1992,463000
6762820591,1670,7,1670,0,4,1947,456000
6762820693,2000,7,1300,700,4,1959,453500
6762820777,2000,7,1250,750,4,1916,450000
6762820943,2170,7,2170,0,3,2003,449950
6762821058,2340,8,2340,0,4,2008,445000
6762821215,1050,6,1050,0,3,1900,440000
6762821845,2440,7,2440,0,4,1957,425000
6762822433,2658,9,2658,0,4,2014,411605
6762823105,1460,7,1460,0,3,1961,395000
6762823106,1980,7,1160,820,4,1983,395000
6762823252,1463,7,1463,0,3,2003,390000
6762823442,1330,7,1330,0,3,1969,386000
6762823464,1710,7,1210,500,3,1978,385000
6762823811,2420,8,2420,0,4,2005,376000
6762823834,960,7,960,0,3,1962,375000
6762824007,1180,7,800,380,3,1981,372500
6762824524,2390,9,2390,0,4,1999,359800
6762824615,920,6,920,0,2,1914,356000
6762824629,2600,8,2600,0,3,2004,355500
6762825248,2070,7,2070,0,4,2004,343000
6762825559,2610,8,2610,0,4,2009,335000
6762825560,1170,6,1170,0,3,1919,335000
6762826163,1660,7,1660,0,3,2009,324500
6762826681,2192,8,2192,0,4,2006,310000
6762827200,1560,7,1560,0,4,1965,299950
6762827313,1910,7,1910,0,4,2005,297500
6762827482,2490,7,1490,1000,5,1989,292000
6762827645,1680,7,1680,0,3,1993,289000
6762828025,1750,7,1350,400,3,1961,279950
6762828141,2068,7,2068,0,4,1976,276000
6762828173,1390,7,1140,250,3,2006,275000
6762828387,1890,7,1090,800,3,1957,270000
6762828388,1500,7,1500,0,3,1968,270000
6762828500,1690,7,1020,670,3,1967,269000
6762828523,2100,8,2100,0,4,2006,268500
6762828959,2330,8,1800,530,4,1990,257000
6762829011,1610,7,1610,0,3,1994,255000
6762829202,1510,7,1030,480,3,1976,250000
6762829622,1150,6,1150,0,3,1957,240000
6762829762,1130,7,1130,0,3,1954,237000
6762830054,1190,6,830,360,2,1941,229000
6762830476,1150,7,1150,0,2,2004,214100
6762830539,1920,7,1370,550,4,1959,210000
6762831025,1010,6,1010,0,3,1958,189000
6762831296,1150,5,1150,0,3,1908,165000
6762810449,4280,11,4280,0,4,2005,1600000
6762810699,2460,9,1930,530,2,1936,1370000
6762810798,4270,10,3180,1090,4,2004,1300000
6762810844,3010,9,2370,640,4,1999,1280000
6762811108,2170,10,1130,1040,3,1979,1150000
6762811179,4400,9,2250,2150,5,1963,1120000
6762811392,3450,10,2430,1020,4,1960,1040000
6762811668,4150,10,4150,0,4,2014,969990
6762811940,2880,9,1710,1170,4,1928,920000
6762812124,3240,10,3240,0,4,2013,895000
6762812229,3010,9,3010,0,4,2014,879950
6762812610,3030,9,3030,0,5,2014,837219
6762812617,2280,8,2280,0,2,2002,835000
6762812896,2230,9,2230,0,4,1959,809950
6762812921,4600,9,2300,2300,5,1956,805000
6762813752,2670,8,2670,0,3,1986,744000
6762813814,2720,8,1800,920,4,1919,739000
6762813847,2820,9,2050,770,4,2013,735000
6762814154,2550,9,2550,0,3,1990,715000
6762814694,2270,9,1820,450,3,1975,680000
6762815053,1980,7,1140,840,3,1926,660000
6762815232,2840,10,2840,0,4,1990,650000
6762816285,2560,7,2560,0,4,2001,600000
6762816467,1990,8,1680,310,4,2005,595000
6762816609,2630,9,2630,0,4,2008,589500
6762816673,2430,8,2430,0,4,2008,585000
6762817057,2400,9,2400,0,3,1993,570000
6762817583,1900,7,1640,260,3,1926,550000
6762817823,2040,7,2040,0,4,1990,545000
6762818029,3080,10,3080,0,3,1990,539500
6762818033,2260,8,1780,480,3,1985,539000
6762818104,1730,8,1730,0,3,1983,535500
6762818419,2440,7,1240,1200,5,1972,525000
6762818850,1480,7,1480,0,3,1974,510000
6762818851,1320,7,1320,0,4,1954,510000
6762819082,1720,7,1720,0,4,1904,500000
6762819936,890,7,890,0,2,1923,475000
6762820099,2030,8,1720,310,3,2001,471000
6762820274,2070,7,2070,0,4,1977,465000
6762820611,1740,7,1170,570,4,1958,455000
6762820612,2050,7,1250,800,4,1959,455000
6762820727,1740,7,990,750,2,1946,452000
6762820778,1480,8,1480,0,3,2005,450000
6762821059,1470,7,1470,0,4,1965,445000
6762821449,3270,8,2720,550,4,1983,435000
6762821450,1260,7,1260,0,2,1926,435000
6762821451,980,6,980,0,3,1940,435000
6762821594,1470,7,1070,400,3,1939,432000
6762822277,1910,7,1340,570,3,1977,415000
6762822586,1880,8,1880,0,4,1978,407193
6762822631,1405,8,1140,265,2,2007,405000
6762822750,2700,7,1350,1350,3,1959,402000
6762823372,1490,7,930,560,2,1956,389250
6762823411,1560,7,1560,0,3,1953,387500
6762823452,1550,6,1550,0,4,1954,385200
6762824411,1020,7,1020,0,3,1953,360000
6762826250,1370,7,1370,0,3,1983,320000
6762826469,1750,7,1150,600,3,1954,315000
6762827073,2680,8,2680,0,4,1999,300000
6762827429,1970,7,1300,670,3,1967,294700
6762827759,780,6,780,0,2,1943,285000
6762828050,2690,7,2690,0,5,2012,279000
6762828389,1900,8,1900,0,4,1975,270000
6762829113,810,7,810,0,2,1948,253500
6762830784,1730,7,1380,350,2,1962,200000
6762831057,1840,7,920,920,3,1953,185000
6762831340,1210,6,1210,0,3,1918,160000
6762816076,3820,9,2040,1780,6,1974,611000
6762817143,2460,8,2460,0,4,1998,568500
6762819472,1730,7,1730,0,3,1985,490000
6762820408,3070,9,3070,0,4,2006,462000
6762810094,4420,11,3150,1270,4,2001,2700000
6762814670,2370,8,2370,0,4,1979,684680
6762817158,2300,8,2300,0,3,2001,567500
6762817947,1780,8,1780,0,4,1994,540000
6762817948,2870,8,2090,780,5,2007,540000
6762818250,3400,9,2470,930,3,2009,530000
6762818852,2450,8,2450,0,4,1976,510000
6762820613,1300,7,1300,0,3,1927,455000
6762821060,1440,7,960,480,2,1915,445000
6762828798,1811,8,1811,0,4,2007,260000
6762810262,4130,11,4130,0,4,1978,1900000
6762810426,4220,10,2110,2110,5,1958,1640000
6762810716,3300,10,3300,0,4,1985,1350000
6762810737,4250,9,3260,990,4,1972,1340000
6762810942,2740,9,2740,0,4,1984,1230000
6762811109,2850,8,1730,1120,3,1954,1150000
6762811438,4060,10,4060,0,4,2002,1020000
6762811598,2730,8,2230,500,4,1909,980000
6762811683,3160,10,3160,0,4,1981,965000
6762812439,2630,9,1580,1050,3,1967,852500
6762812660,2030,7,1630,400,4,1926,831000
6762813605,2050,8,1370,680,4,1987,750000
6762813755,2610,10,2610,0,4,1988,743700
6762813815,2800,9,2800,0,4,1999,739000
6762814351,3150,9,3150,0,4,2000,700000
6762815343,2350,8,2350,0,4,1994,649950
6762815371,2380,10,2380,0,4,1992,648000
6762815468,2140,8,2140,0,3,1991,640000
6762815729,2030,8,2030,0,4,1976,627000
6762815758,2210,8,1390,820,3,1958,625000
6762815888,2590,8,2590,0,3,2004,620000
6762816131,3190,10,3190,0,4,2006,609900
6762816186,2670,9,2670,0,3,1981,605000
6762816286,2630,9,2630,0,3,2004,600000
6762816388,3730,10,2440,1290,4,1991,599950
6762816674,2470,8,2470,0,4,1937,585000
6762816861,1870,8,1870,0,2,2003,579000
6762817148,2050,7,1070,980,3,1977,568000
6762817265,2800,8,2800,0,4,2001,563500
6762817402,2070,7,1140,930,3,1948,559000
6762817506,1760,8,1760,0,3,1977,554000
6762817545,1380,9,1380,0,2,2006,552000
6762817584,2260,7,2260,0,3,2005,550000
6762817585,2700,8,1440,1260,4,1968,550000
6762817586,1380,7,1380,0,3,1900,550000
6762817807,1530,8,1530,0,3,1998,546000
6762818015,2190,8,1240,950,3,1963,539950
6762818090,1900,7,1900,0,3,2005,536000
6762818420,2470,8,2470,0,3,1980,525000
6762819048,1300,8,1300,0,3,1963,502000
6762819083,2240,7,2240,0,4,1965,500000
6762819567,1500,8,1240,260,3,2004,489000
6762819767,2220,8,2220,0,4,1964,480000
6762819937,1980,7,1980,0,4,1952,475000
6762820100,2330,8,2330,0,4,1998,471000
6762820779,1640,7,1110,530,3,1940,450000
6762821158,2170,8,2170,0,4,1992,442500
6762821216,2240,7,1120,1120,3,1948,440000
6762821452,1890,7,1230,660,3,1973,435000
6762821453,800,7,800,0,2,1906,435000
6762821772,1310,7,780,530,3,1986,428000
6762821846,910,6,910,0,2,1905,425000
6762822229,920,6,920,0,2,1919,417000
6762822458,1410,7,910,500,3,1956,410000
6762822459,1960,7,1960,0,3,2006,410000
6762822712,710,7,710,0,2,1943,403950
6762822808,1140,7,1140,0,2,1942,400000
6762822809,2370,8,2370,0,4,2013,400000
6762823028,1720,7,1240,480,3,2004,398000
6762823253,2700,8,2700,0,4,1968,390000
6762823465,1230,7,1230,0,3,1987,385000
6762823751,2020,7,2020,0,4,1960,379000
6762823772,730,7,730,0,2,1946,378500
6762824183,1710,7,1710,0,3,1958,368000
6762824213,2190,8,2190,0,4,1993,367300
6762824252,1800,8,1800,0,3,2011,365000
6762824328,2500,8,2500,0,3,1997,364900
6762824782,1060,7,960,100,2,2008,352750
6762825094,1240,7,1240,0,3,1978,347000
6762825139,1210,8,1210,0,3,2008,345000
6762825140,1340,8,1120,220,2,2008,345000
6762825299,1920,8,1500,420,4,1975,341000
6762825929,1440,7,1440,0,3,1977,328000
6762826004,1350,7,1350,0,3,1986,325000
6762826470,1480,8,1150,330,3,2010,315000
6762826831,1980,8,1980,0,4,2003,307550
6762826885,1590,8,1590,0,3,1974,305100
6762826982,740,7,740,0,2,1949,304700
6762827532,2390,7,2390,0,4,1974,290000
6762827668,1860,7,1200,660,3,1963,288350
6762827760,1680,7,1680,0,3,1987,285000
6762827927,1610,6,1610,0,2,1948,280000
6762828390,1990,7,1270,720,4,1999,270000
6762828611,1000,6,1000,0,2,1960,265000
6762829012,1200,6,1200,0,2,1917,255000
6762829188,2210,8,2210,0,3,1969,250250
6762829203,2520,7,1510,1010,5,1928,250000
6762829623,1910,6,1910,0,4,1934,240000
6762829777,1330,7,1330,0,3,1998,236000
6762829797,1590,6,1590,0,3,1944,235000
6762829869,1330,6,1330,0,3,1948,234999
6762830030,1300,7,1300,0,4,1969,229950
6762830489,1150,7,1150,0,3,1963,213400
6762830491,1980,7,1480,500,4,1978,213000
6762830500,1030,6,1030,0,2,1938,212500
6762810314,5270,10,4010,1260,5,1977,1800000
6762810891,3700,11,2620,1080,4,1988,1250000
6762810923,2830,9,2460,370,5,1923,1240000
6762810943,3040,9,3040,0,4,2001,1230000
6762811060,3630,9,2470,1160,5,2004,1180000
6762811296,2940,9,2230,710,3,1988,1070000
6762811316,3230,9,2480,750,5,2014,1060000
6762811415,3760,10,3760,0,5,1983,1030000
6762811972,2930,9,2930,0,6,2013,915000
6762812094,2580,8,2580,0,4,2013,899900
6762812125,2550,9,1610,940,5,1953,895000
6762812296,3340,9,2470,870,4,1998,870000
6762812968,1620,8,1620,0,3,1926,800000
6762813606,2750,7,2150,600,5,1937,750000
6762813705,1580,7,1580,0,3,1926,749000
6762813730,3490,10,3490,0,4,2006,745000
6762813772,3000,9,3000,0,3,1995,740000
6762814227,2440,7,1990,450,3,2000,710000
6762814352,2080,7,1160,920,3,1954,700000
6762814353,3100,8,3100,0,5,1950,700000
6762814488,2540,9,2540,0,3,2005,695000
6762814489,2550,9,2550,0,3,2001,695000
6762814490,3510,10,3510,0,4,2001,695000
6762814695,1760,8,1460,300,3,1960,680000
6762815103,1820,8,1620,200,3,1957,659500
6762815106,2510,9,2510,0,3,1996,659000
6762815145,2050,7,1460,590,3,1962,655275
6762815233,2560,7,2560,0,4,1973,650000
6762816144,2490,8,1400,1090,4,1983,608000
6762816608,3870,10,2530,1340,4,2001,589900
6762817044,2750,7,2250,500,4,1916,571000
6762817134,3670,8,2060,1610,5,1952,569000
6762817175,2440,8,1340,1100,4,1954,566000
6762817273,2340,8,1500,840,3,1972,563000
6762817411,2180,7,1020,1160,4,1900,558000
6762817455,2180,8,1680,500,3,1930,555000
6762818200,2790,8,2790,0,4,2013,533112
6762818421,2880,9,2880,0,5,2006,525000
6762818706,2110,6,1080,1030,3,1919,516200
6762818725,1800,7,1800,0,3,1996,515000
6762818985,2340,8,2340,0,3,1995,505000
6762819234,1060,8,940,120,2,2005,499950
6762819267,1220,7,920,300,2,1926,499000
6762819473,2220,9,1640,580,3,1980,490000
6762819474,3020,10,3020,0,4,1994,490000
6762819718,1210,7,1210,0,4,1955,483300
6762819768,2320,7,1140,1180,4,1910,480000
6762819769,2732,8,1870,862,5,1975,480000
6762819938,1490,8,1490,0,2,1983,475000
6762820117,2290,8,1620,670,3,1965,470000
6762821051,1470,7,1020,450,2,1941,445434
6762821217,1290,7,1290,0,3,2000,440000
6762821454,1970,7,1450,520,5,1986,435000
6762821567,1870,7,1270,600,3,1959,433000
6762821723,2010,8,1570,440,3,1951,429950
6762821746,1410,8,1410,0,3,2005,429000
6762822062,860,6,860,0,2,1916,420000
6762822220,1390,7,1390,0,4,1941,417500
6762822278,2090,8,2090,0,3,2000,415000
6762822723,1100,7,1100,0,2,1926,403000
6762822810,2530,7,1440,1090,4,1978,400000
6762822941,710,7,710,0,2,1943,399950
6762823219,1940,8,1940,0,4,1990,392000
6762823466,1720,7,860,860,4,1971,385000
6762823632,1680,7,1130,550,4,1959,380000
6762823821,1530,8,1530,0,3,1975,375500
6762823835,2210,7,2210,0,4,1999,375000
6762824137,1960,7,1960,0,4,2002,369990
6762824228,1520,8,1520,0,3,1976,366000
6762824412,1630,7,1630,0,4,1968,360000
6762824502,1890,7,1890,0,3,1952,359950
6762824844,1392,7,1392,0,2,1978,350000
6762825141,1540,7,920,620,3,1955,345000
6762825561,2430,7,1410,1020,3,1978,335000
6762826471,1930,7,1930,0,4,1992,315000
6762826472,1740,7,950,790,2,1924,315000
6762826682,1420,7,1100,320,3,1984,310000
6762826683,1740,7,1740,0,4,1965,310000
6762826684,1780,7,1230,550,3,1990,310000
6762826840,1150,6,1150,0,4,1947,307000
6762826851,1010,7,1010,0,2,1981,306888
6762827001,2009,8,2009,0,4,2014,303210
6762827761,1651,6,1651,0,2,1946,285000
6762828086,1940,7,1940,0,4,1990,278500
6762828501,1560,7,1560,0,3,2003,269000
6762828533,1380,7,870,510,2,1943,268000
6762829123,2040,7,1020,1020,3,1962,253000
6762829170,1320,7,1320,0,3,1975,251750
6762829204,1590,7,1130,460,3,1984,250000
6762830087,1200,6,1200,0,4,1944,227000
6762830132,1760,7,920,840,3,1979,225000
6762830334,970,6,970,0,3,1967,219900
6762830856,920,7,920,0,3,1962,199500
6762831096,1330,7,1330,0,3,1973,183000
6762831188,1930,7,1030,900,6,1971,175000
6762831297,970,7,970,0,3,1965,165000
6762831448,1010,7,1010,0,3,1959,149500
6762831588,1120,5,860,260,4,1939,100000
6762810021,10040,11,7680,2360,5,1940,7060000
6762810082,8670,13,6120,2550,5,1965,2890000
6762810228,2880,8,1520,1360,3,1950,1990000
6762810700,4210,12,4210,0,5,1995,1370000
6762811250,2340,10,2340,0,5,1922,1090000
6762811454,3760,11,3760,0,4,1987,1010000
6762812207,2510,8,1590,920,5,1925,881000
6762812248,3470,10,3470,0,4,1995,875000
6762812438,3320,9,2650,670,4,1977,852600
6762812451,2070,9,1270,800,3,1910,850830
6762812845,3370,8,1920,1450,4,1948,813000
6762812897,3280,10,3280,0,4,2001,809950
6762812969,2690,9,2120,570,4,1909,800000
6762813037,2210,8,2210,0,3,1916,799000
6762813162,4500,10,4500,0,3,2004,785000
6762813463,2430,8,1230,1200,3,1949,762400
6762813762,2810,10,2810,0,4,1997,742000
6762813773,2490,9,1490,1000,4,1979,740000
6762813848,2460,7,1450,1010,4,1909,735000
6762814108,3240,10,3240,0,5,2013,719950
6762814354,2500,7,1390,1110,3,1948,700000
6762814972,4250,7,3020,1230,6,1902,665000
6762815125,4140,11,4140,0,4,2002,657500
6762815234,1030,8,1030,0,2,1928,650000
6762815945,2090,7,1790,300,4,1927,619400
6762816287,2910,7,1510,1400,5,1979,600000
6762816409,2790,8,2790,0,4,1989,599000
6762816635,1680,7,980,700,4,1950,588000
6762816776,2240,8,2240,0,4,1976,580379
6762817045,2600,9,2600,0,3,1988,571000
6762817313,1990,8,1990,0,3,2004,560200
6762817787,1650,8,1650,0,3,2010,547500
6762817824,2180,8,1850,330,3,1979,545000
6762817825,1240,8,1240,0,2,2014,545000
6762818119,2520,8,2520,0,5,1978,535000
6762818251,1550,7,1050,500,3,1927,530000
6762818378,1640,7,840,800,2,1921,527000
6762818573,1730,7,1400,330,3,1980,522000
6762818708,2550,7,2550,0,4,2007,516000
6762818726,3370,7,3200,170,3,1951,515000
6762818804,1720,8,1220,500,3,1986,514000
6762819351,3440,8,3280,160,6,2007,495000
6762819601,1295,9,1105,190,2,2007,487028
6762819908,1140,6,1140,0,3,1908,476000
6762819939,1630,7,1630,0,3,2005,475000
6762820275,1470,7,980,490,4,1955,465000
6762820276,2090,7,1320,770,4,1965,465000
6762820367,2180,8,2180,0,4,1989,464000
6762820439,2060,7,1030,1030,3,1929,460000
6762820614,3170,9,3170,0,4,2001,455000
6762820780,2300,7,2300,0,4,1955,450000
6762821455,1420,7,1420,0,3,2004,435000
6762821801,1860,7,1860,0,4,1901,427000
6762822279,2550,7,2550,0,4,2009,415000
6762822632,1640,8,1640,0,3,1948,405000
6762822942,710,7,710,0,2,1943,399950
6762823443,1270,7,1080,190,3,2004,386000
6762823609,1460,7,1460,0,3,1954,381000
6762824030,1370,7,1370,0,3,1964,371500
6762824034,890,7,890,0,3,1951,371000
6762824641,750,4,550,200,1,1946,355000
6762824729,940,7,940,0,3,1965,354000
6762824785,1170,7,1170,0,3,1962,352500
6762824845,1460,8,1130,330,3,2006,350000
6762825045,1430,8,1430,0,3,2002,349000
6762825562,2030,7,1230,800,4,1963,335000
6762825689,720,6,720,0,2,1942,333000
6762825758,2210,9,2210,0,3,1989,330000
6762825870,2456,8,2456,0,3,2012,329950
6762826005,1790,7,1130,660,3,1978,325000
6762826421,1160,7,1160,0,3,1952,317000
6762826808,2250,8,2250,0,3,1994,308900
6762827356,2100,7,1410,690,5,1999,295000
6762827483,2414,8,2414,0,4,2006,292000
6762827525,860,6,860,0,2,1931,290300
6762827533,1520,7,1520,0,3,1968,290000
6762827762,1870,7,1870,0,3,2005,285000
6762827928,1860,7,1860,0,3,1989,280000
6762828131,1350,7,1350,0,2,1952,276900
6762828746,1160,7,1160,0,3,1962,262500
6762829205,982,8,806,176,2,2006,250000
6762829383,1510,7,1510,0,5,1959,248000
6762829624,1360,7,1360,0,3,1984,240000
6762829884,1640,6,1640,0,3,1910,234000
6762829950,1910,6,1110,800,5,1951,230000
6762830267,1050,6,1050,0,3,1942,220000
6762830473,1570,7,1310,260,3,1977,214950
6762830785,700,5,700,0,2,1953,200000
6762831453,620,5,620,0,1,1939,148000
6762831570,800,6,800,0,2,1927,110000
6762810167,4860,10,3100,1760,5,1905,2250000
6762810387,3000,9,3000,0,4,1937,1690000
6762810555,4030,10,4030,0,4,2006,1490000
6762810748,3200,8,1600,1600,5,1965,1330000
6762810924,4410,11,4410,0,5,2006,1240000
6762810944,5730,11,4280,1450,4,1991,1230000
6762811061,3200,8,1860,1340,4,1948,1180000
6762811297,3270,11,3270,0,4,1989,1070000
6762811416,2370,9,2370,0,4,2003,1030000
6762811941,2420,9,1870,550,4,1911,920000
6762812058,2460,9,2460,0,4,1957,900000
6762812150,2060,8,2060,0,3,1966,890000
6762812376,3960,10,3960,0,4,2005,860000
6762812456,2130,9,2130,0,4,1972,850000
6762812618,2790,8,1600,1190,3,1977,835000
6762812768,2683,9,2683,0,4,1987,822000
6762813068,2420,9,1500,920,3,1979,795000
6762813141,3010,9,3010,0,4,2005,789500
6762813186,3950,9,2460,1490,3,1989,784000
6762813756,2110,8,2110,0,3,1961,743000
6762814134,2480,9,2480,0,3,2000,717000
6762814285,1900,7,1410,490,3,1942,706000
6762814446,3280,9,3280,0,4,1996,699000
6762814696,2570,9,2570,0,3,2007,680000
6762814761,2460,8,1370,1090,3,1952,678500
6762814897,2050,8,1730,320,3,1956,670000
6762815054,2340,8,2160,180,3,1925,660000
6762815139,2710,7,1460,1250,4,1919,656500
6762815469,3690,9,2540,1150,5,2006,640000
6762815889,1430,7,1300,130,2,1929,620000
6762816080,2180,8,2180,0,4,1984,610750
6762816288,1480,8,1480,0,3,1914,600000
6762816410,2820,7,1450,1370,5,1967,599000
6762816512,1870,7,1200,670,4,1937,594000
6762816675,1910,8,1530,380,3,2007,585000
6762816786,2060,7,2060,0,5,1903,580000
6762816880,3140,9,1770,1370,4,1966,578000
6762816926,1510,8,1310,200,2,1935,575000
6762817306,1710,8,1710,0,3,2004,561000
6762817324,1880,7,1090,790,4,1944,560000
6762817826,1510,7,1510,0,3,1909,545000
6762818231,2120,9,2120,0,3,1988,531000
6762818595,2080,7,1260,820,4,1926,520000
6762818853,1600,7,1600,0,3,1967,510000
6762819063,1970,8,1370,600,3,1976,501000
6762819297,2990,8,2990,0,5,1996,498500
6762819352,2140,7,2140,0,4,2003,495000
6762819353,1769,7,1769,0,3,1955,495000
6762819552,2640,9,2640,0,4,1986,489950
6762819628,2470,9,2470,0,4,1989,485000
6762819770,1250,8,1250,0,3,2005,480000
6762820262,1940,7,1940,0,5,1957,465250
6762820994,1630,7,890,740,2,1940,448000
6762821061,1050,7,910,140,3,1947,445000
6762821062,2460,7,1340,1120,5,1911,445000
6762821218,1210,7,1210,0,3,1910,440000
6762821219,1710,7,1200,510,3,1926,440000
6762821220,1560,7,1030,530,3,1972,440000
6762821644,1890,6,1110,780,4,1947,430000
6762822633,1330,7,900,430,3,1984,405000
6762822751,1240,7,1000,240,3,2008,402000
6762822811,1590,6,970,620,3,1938,400000
6762823039,1180,7,1180,0,3,1948,397990
6762823610,1800,6,900,900,3,1950,381000
6762824057,1220,6,1220,0,2,1947,370000
6762824349,1651,8,1341,310,3,2008,363000
6762824846,2300,7,1340,960,4,1904,350000
6762825008,1060,7,1060,0,3,1966,349950
6762825264,2080,8,2080,0,3,2002,342500
6762825520,1170,7,1170,0,2,2009,336750
6762825690,1910,6,1910,0,4,1963,333000
6762826251,1100,7,1100,0,2,1947,320000
6762826473,970,6,970,0,2,1908,315000
6762826474,1880,8,1880,0,3,1993,315000
6762826619,1070,7,1070,0,2,1999,312500
6762826685,1880,7,1100,780,5,1997,310000
6762826864,2490,7,2490,0,4,2001,306000
6762827074,1470,7,1180,290,3,2008,300000
6762827193,1970,8,1970,0,3,1988,299995
6762827251,2210,7,1450,760,3,1966,299000
6762827436,2210,8,1490,720,4,1990,294000
6762827929,420,5,420,0,1,1922,280000
6762828909,1490,7,1490,0,4,1966,259000
6762829384,1770,7,1770,0,4,2003,248000
6762829798,1840,7,1500,340,3,1985,235000
6762830222,910,6,910,0,2,1957,223000
6762830540,1200,7,1200,0,4,1968,210000
6762830541,1130,7,1130,0,4,1970,210000
6762831227,820,7,820,0,2,1965,173000
6762810347,4310,10,2510,1800,3,1982,1740000
6762810366,3170,10,1990,1180,2,1900,1700000
6762810738,4200,9,2910,1290,5,1906,1340000
6762811161,3010,9,2000,1010,6,2014,1130000
6762811180,2540,8,2340,200,5,1954,1120000
6762811417,2750,9,1960,790,4,1905,1030000
6762811623,3100,9,1660,1440,5,1973,975000
6762811749,3770,10,3770,0,4,1989,950000
6762812002,2350,9,2350,0,5,1993,910000
6762812151,2770,8,2770,0,4,1974,890000
6762812201,3670,10,3670,0,4,1999,883000
6762812361,4120,10,4120,0,4,1997,863000
6762812518,2280,9,2280,0,2,1990,849900
6762812537,4070,9,4070,0,4,2002,845000
6762812765,2320,7,1720,600,5,1926,822500
6762812862,1980,9,1320,660,3,1952,810000
6762813038,2860,8,2860,0,3,2000,799000
6762813069,3200,9,2670,530,4,2007,795000
6762813284,3140,7,1940,1200,4,1939,775000
6762813480,2420,8,1700,720,4,1958,760000
6762813983,3210,8,1830,1380,5,1968,725000
6762814119,2910,7,1920,990,3,1900,718500
6762814470,3650,8,3650,0,4,1978,697000
6762814479,2300,8,1510,790,3,1930,696000
6762814973,2790,9,2790,0,4,1989,665000
6762815861,3320,8,2190,1130,5,1975,622500
6762815993,2350,8,1800,550,3,1978,615000
6762816551,2010,8,2010,0,4,1989,590000
6762816617,2440,7,2440,0,4,1961,589000
6762816618,2250,7,1250,1000,3,1925,589000
6762816676,1870,7,1580,290,3,1927,585000
6762816787,2040,8,2040,0,3,1992,580000
6762816893,1760,7,1230,530,3,1967,577000
6762816927,1384,8,1144,240,3,2006,575000
6762817438,1640,7,1090,550,3,1948,556000
6762817949,3610,8,3610,0,5,2003,540000
6762818058,1460,7,1260,200,3,1906,538000
6762818236,1540,7,1200,340,3,1926,530100
6762818811,2020,7,1010,1010,4,1958,513000
6762819235,1830,7,1430,400,3,1926,499950
6762819629,1580,8,1580,0,3,1985,485000
6762819940,1580,7,1200,380,3,1981,475000
6762820511,1850,6,1100,750,3,1919,459950
6762820556,2020,7,1220,800,3,1957,458000
6762820684,2630,9,2630,0,4,1979,454000
6762821221,2010,7,1220,790,4,1974,440000
6762821456,1500,7,1500,0,3,1997,435000
6762821645,1910,8,1910,0,3,1971,430000
6762822176,2690,8,2690,0,4,1993,419000
6762822262,1750,7,1750,0,4,2009,415500
6762823467,1920,7,1060,860,3,1921,385000
6762823468,2050,7,2050,0,4,2006,385000
6762823633,2540,8,1870,670,4,2000,380000
6762823741,1410,7,1290,120,3,2005,379500
6762824058,900,6,900,0,2,1951,370000
6762824059,2220,7,2220,0,4,2001,370000
6762824154,1650,7,1100,550,3,1961,369500
6762824847,1820,7,1230,590,3,1976,350000
6762825142,1800,7,1240,560,2,1987,345000
6762825759,1070,7,720,350,3,2005,330000
6762826006,2070,8,2070,0,3,1997,325000
6762826157,1880,7,1880,0,4,2000,324900
6762826895,1210,7,610,600,3,1983,305000
6762826988,1280,6,1280,0,3,1947,304000
6762827075,2700,8,1560,1140,4,1966,300000
6762827252,1180,7,1180,0,3,1962,299000
6762827763,1840,7,920,920,3,1905,285000
6762828612,1900,6,1900,0,4,1958,265000
6762829185,1930,7,1120,810,4,1981,250600
6762829206,1400,7,1400,0,3,2012,250000
6762829799,1900,6,950,950,3,1980,235000
6762829951,930,6,930,0,2,1986,230000
6762830419,710,6,710,0,2,1943,215000
6762830542,1440,8,1440,0,2,1978,210000
6762830663,1340,7,1340,0,3,1978,206135
6762830684,1290,7,1290,0,3,1976,205000
6762831240,1520,6,1020,500,4,1920,171000
6762831404,1270,6,1270,0,3,1944,153000
6762831525,1150,6,1150,0,2,1950,129000
6762812202,2960,10,2960,0,4,1985,883000
6762812457,2920,8,1660,1260,5,1968,850000
6762813849,2450,8,2450,0,4,2010,735000
6762818252,1930,8,1930,0,3,2005,530000
6762818422,2360,8,2360,0,4,2008,525000
6762819325,1980,7,1090,890,2,1923,496752
6762823043,1510,7,1070,440,3,1972,397500
6762825760,1430,7,1430,0,3,1950,330000
6762811142,2500,8,1960,540,4,1926,1140000
6762815202,2700,9,2700,0,4,1990,652500
6762815235,2140,7,1290,850,3,1953,650000
6762818589,1900,7,950,950,3,1940,520500
6762818969,2430,7,1370,1060,5,1957,506000
6762822249,1110,7,1110,0,3,1957,416000
6762828466,1890,8,1730,160,3,2002,269950
6762810256,3070,9,2070,1000,4,1950,1920000
6762810348,3040,9,2080,960,4,1926,1740000
6762810361,2940,10,2440,500,3,1978,1710000
6762811211,3530,8,2630,900,4,1958,1100000
6762811514,2800,10,2800,0,4,1992,999000
6762811694,3280,10,3280,0,4,2007,963000
6762811936,2220,7,1490,730,4,1954,921000
6762812049,3030,9,3030,0,4,2003,902000
6762812093,3290,9,2360,930,4,2006,899950
6762812365,3190,11,3190,0,4,1990,862000
6762812437,3450,9,3450,0,4,2014,852880
6762812458,4140,10,3160,980,4,2003,850000
6762812712,1890,8,1890,0,4,1919,825000
6762812713,2810,8,1710,1100,4,1973,825000
6762813051,2670,10,1720,950,3,2013,798800
6762813093,4290,10,4290,0,4,2004,792500
6762813453,1990,7,1100,890,3,1939,763101
6762813528,3100,9,3100,0,3,2002,759950
6762813687,3430,9,3430,0,4,2014,749995
6762814442,2690,9,2690,0,4,2002,699850
6762814545,1600,7,850,750,2,1918,690000
6762814632,2840,8,2840,0,4,2008,685000
6762814697,2500,8,2500,0,4,2010,680000
6762814951,1720,8,1720,0,3,1907,667000
6762815055,1840,7,1060,780,6,1900,660000
6762815236,2610,8,1910,700,4,1910,650000
6762815534,2110,9,2110,0,3,2005,638000
6762815633,2640,7,2640,0,5,2003,632500
6762816907,2440,8,2440,0,4,2002,576000
6762816928,2120,8,2120,0,4,1985,575000
6762817176,2170,8,2170,0,4,1987,566000
6762817190,3130,9,3130,0,4,1981,565000
6762817507,3380,9,2700,680,3,1999,554000
6762817546,1120,7,820,300,3,1912,552000
6762817827,1940,8,1440,500,3,1975,545000
6762817906,2650,8,2650,0,4,2014,542525
6762818190,1700,8,1700,0,3,2005,534500
6762818253,2050,8,2050,0,4,1988,530000
6762818545,1120,7,1120,0,2,1910,524000
6762818553,1420,8,1420,0,3,2006,523950
6762818669,1740,7,1220,520,4,1976,518000
6762819084,2280,7,2280,0,4,1960,500000
6762819085,1540,6,770,770,3,1947,500000
6762819268,1750,7,1470,280,3,1968,499000
6762819432,2570,8,2570,0,5,2006,492500
6762820118,1510,7,1510,0,3,1956,470000
6762820119,1760,7,1160,600,3,1958,470000
6762820208,1350,8,1120,230,3,2007,468500
6762820277,2670,7,1640,1030,3,1966,465000
6762820440,1550,7,860,690,3,1949,460000
6762820441,1090,8,970,120,2,1951,460000
6762820442,890,6,760,130,2,1919,460000
6762820615,1310,6,1310,0,2,1970,455000
6762820781,3550,8,2960,590,6,1948,450000
6762821063,1890,8,1890,0,3,1976,445000
6762821457,2300,8,2300,0,3,2003,435000
6762821458,1980,8,1980,0,3,2007,435000
6762821747,2340,7,2340,0,5,2009,429000
6762821802,1830,8,1520,310,3,1991,427000
6762822205,2360,7,1460,900,4,1960,418000
6762822206,1220,7,1220,0,4,1965,418000
6762822280,1800,7,1000,800,4,1923,415000
6762822460,1580,7,1580,0,4,1953,410000
6762822812,1580,7,1130,450,4,1947,400000
6762823469,1690,7,870,820,4,1984,385000
6762823470,1590,8,1590,0,3,2000,385000
6762823471,2960,9,2960,0,4,2006,385000
6762823472,830,6,830,0,2,1928,385000
6762823777,2760,8,1600,1160,5,1960,378000
6762823836,1240,7,1040,200,4,1908,375000
6762823837,2400,6,2400,0,4,1913,375000
6762823838,2040,8,2040,0,4,1973,375000
6762823995,1770,7,1140,630,3,1926,373000
6762824032,1530,7,1530,0,3,1977,371025
6762824593,1210,8,1210,0,2,2014,357186
6762824748,1760,7,1760,0,4,1987,353500
6762825317,1212,7,1212,0,3,2004,340000
6762825563,2040,7,1340,700,3,1957,335000
6762825719,960,7,760,200,1,1908,332000
6762826252,1200,8,1200,0,3,2005,320000
6762826792,1150,7,1150,0,3,1979,309212
6762826989,1810,7,1110,700,4,1967,304000
6762827076,1940,8,1200,740,5,2007,300000
6762827357,1770,7,1030,740,3,1960,295000
6762827747,1960,8,1960,0,4,1967,285500
6762827838,1880,7,1880,0,3,2009,284000
6762828123,1100,7,1100,0,3,1957,277000
6762828613,1000,7,1000,0,3,1969,265000
6762829462,1200,6,980,220,2,1943,245000
6762829800,880,7,880,0,2,1999,235000
6762829952,1400,7,1400,0,3,1957,230000
6762830268,2240,7,1370,870,4,1988,220000
6762830269,1410,7,1410,0,3,1940,220000
6762831097,1070,6,1070,0,3,1957,183000
6762831189,1220,7,1220,0,3,1973,175000
6762831426,1230,6,1230,0,3,1949,150000
6762831599,760,5,760,0,2,1947,92000
6762810027,9640,12,4820,4820,5,1983,4670000
6762810123,4340,11,3060,1280,3,1993,2480000
6762810216,4100,11,2540,1560,4,1934,2030000
6762810353,3700,10,1850,1850,4,1976,1730000
6762810497,4360,10,2960,1400,3,2008,1560000
6762810513,2880,9,1710,1170,3,1958,1540000
6762810749,4420,11,4420,0,4,2013,1330000
6762811001,4170,11,4170,0,4,2004,1200000
6762811040,2500,9,2500,0,3,1905,1190000
6762811075,2570,9,2570,0,4,2000,1170000
6762811455,2420,10,1840,580,3,2006,1010000
6762811456,2650,9,2060,590,4,2001,1010000
6762811750,2750,9,1810,940,3,1978,950000
6762811839,2960,8,1480,1480,3,1952,936000
6762812059,3870,10,3870,0,5,1998,900000
6762812297,3010,10,1940,1070,4,1951,870000
6762812328,3130,9,2570,560,5,2014,866059
6762812433,3150,10,2480,670,4,1986,854000
6762812570,3860,10,3120,740,4,1996,840000
6762812608,3010,10,3010,0,5,1994,837700
6762812756,3670,8,2800,870,7,1964,824000
6762812863,2670,9,2670,0,3,2003,810000
6762812901,2590,9,2590,0,3,1988,809000
6762813417,1570,8,1050,520,3,1971,765000
6762813583,2940,9,2940,0,4,1991,752000
6762813827,2300,8,2300,0,3,2005,738500
6762813948,1580,8,1580,0,3,1908,729000
6762813984,2630,8,2630,0,4,1994,725000
6762814074,2650,8,2110,540,4,1988,720000
6762814801,2740,8,1370,1370,6,1953,675000
6762814935,2700,8,2700,0,4,1976,669000
6762814946,1880,7,1030,850,3,1927,667500
6762815470,1380,7,1380,0,3,1948,640000
6762815978,2490,9,2490,0,4,1983,616000
6762816179,2830,9,2830,0,3,1989,605500
6762816187,2010,8,2010,0,3,1985,605000
6762816788,2700,7,1540,1160,5,1962,580000
6762817325,1710,7,1320,390,5,1926,560000
6762817326,2340,7,1170,1170,3,1971,560000
6762817508,1120,7,1120,0,4,1946,554000
6762817587,2240,8,2240,0,3,1976,550000
6762817758,1380,9,1380,0,2,2006,549000
6762817793,1720,7,1200,520,4,1926,547000
6762817828,2030,7,1590,440,4,1967,545000
6762818091,1990,8,1990,0,4,1991,536000
6762818120,3070,9,3070,0,4,2006,535000
6762818655,3250,8,3250,0,4,2009,519000
6762818970,2180,8,1480,700,3,1961,506000
6762819258,2970,9,2970,0,3,1998,499500
6762819425,2030,7,2030,0,4,1975,493000
6762819852,2300,8,2300,0,3,2008,479500
6762819858,1230,8,1020,210,2,2004,479000
6762819941,2280,7,1150,1130,3,1985,475000
6762820061,900,7,900,0,2,1909,473000
6762820081,1180,8,1180,0,3,2010,472000
6762820257,2340,7,2340,0,4,2001,465950
6762820278,1430,7,995,435,2,2006,465000
6762820279,1494,7,1494,0,2,1943,465000
6762820557,1550,7,1350,200,4,1918,458000
6762820752,1670,7,1670,0,4,2005,451000
6762820944,2470,8,2470,0,4,1999,449950
6762821222,1450,7,1450,0,4,1962,440000
6762821459,1230,7,1230,0,2,1928,435000
6762821460,1230,8,1080,150,3,2009,435000
6762821646,1730,8,1370,360,3,1978,430000
6762821647,980,7,980,0,3,1950,430000
6762822044,2890,8,2890,0,3,2000,421000
6762822281,1610,7,1610,0,4,1967,415000
6762822634,1880,8,1480,400,3,1968,405000
6762822752,1450,7,1010,440,3,1968,402000
6762822813,2140,7,2140,0,3,1986,400000
6762823444,1620,8,1620,0,2,2008,386000
6762823583,2210,8,2210,0,4,1993,382500
6762823634,2150,8,2150,0,4,1991,380000
6762823728,2800,7,2800,0,5,1995,379900
6762823839,1160,7,1160,0,3,1976,375000
6762824848,1380,8,1380,0,3,2015,350000
6762824849,1260,8,1260,0,2,2005,350000
6762825143,2250,8,1480,770,4,1975,345000
6762825144,1680,7,1680,0,3,2007,345000
6762825249,1270,8,1270,0,3,2004,343000
6762825275,740,6,740,0,2,1948,342000
6762825720,1530,7,1270,260,3,1993,332000
6762825761,3040,7,3040,0,3,2003,330000
6762826007,2610,9,2610,0,4,1987,325000
6762826253,860,7,860,0,3,1927,320000
6762826686,1870,7,1870,0,4,1956,310000
6762826896,2110,7,1360,750,3,1973,305000
6762827421,1660,7,1660,0,4,1994,294999
6762827720,1413,8,1413,0,3,2011,286800
6762827930,1930,7,1360,570,4,1988,280000
6762828332,1380,7,1380,0,3,1989,272000
6762828492,1480,6,940,540,2,1978,269500
6762828799,1440,7,1090,350,3,1958,260000
6762828800,1270,7,1150,120,3,1948,260000
6762828910,1870,7,1270,600,3,1986,259000
6762829013,1700,7,1700,0,3,1987,255000
6762829124,880,6,880,0,3,1945,253000
6762829207,1088,7,1088,0,2,1983,250000
6762829208,1800,7,1800,0,4,1998,250000
6762829209,1160,7,1160,0,3,1998,250000
6762829413,1370,7,1370,0,3,1982,247200
6762829587,1280,7,1280,0,3,1988,242000
6762829701,1140,6,1140,0,3,1943,239950
6762829801,1190,7,1190,0,3,1968,235000
6762830031,1410,7,1410,0,3,1983,229950
6762830543,930,6,930,0,1,1948,210000
6762830667,1320,7,1320,0,3,1967,206000
6762830725,1740,7,1180,560,4,1978,204950
6762830880,1430,7,820,610,3,1980,198000
6762831037,1180,7,1180,0,3,1977,187500
6762831244,1920,7,1220,700,4,1966,170000
6762831474,1440,6,1440,0,4,1948,142500
6762810029,6430,12,6430,0,4,2001,4490000
6762810065,4850,10,3850,1000,4,1989,3000000
6762810450,6050,11,6050,0,6,2001,1600000
6762810641,2020,10,1790,230,3,1937,1400000
6762810642,3870,11,3870,0,4,2005,1400000
6762810684,4290,11,2690,1600,4,1997,1380000
6762811088,4680,10,3360,1320,4,2005,1160000
6762811624,4270,10,2680,1590,4,1991,975000
6762811992,3640,11,3640,0,4,1999,913000
6762812060,3020,8,3020,0,6,1952,900000
6762812416,2190,8,1800,390,4,1918,855000
6762812459,3450,8,2350,1100,5,1972,850000
6762812714,3810,9,3810,0,4,1938,825000
6762812777,3170,9,3170,0,4,2008,820000
6762813365,2910,9,2910,0,3,1990,770000
6762813366,3210,10,3210,0,4,1995,770000
6762813450,2790,9,2790,0,4,1997,764000
6762813810,2420,8,1690,730,3,1989,739888
6762814218,1980,6,990,990,4,1948,711000
6762814546,1540,9,1540,0,3,2013,690000
6762814604,3450,10,3450,0,3,1983,688000
6762815237,1260,7,1260,0,5,1926,650000
6762815238,2920,8,1620,1300,3,1981,650000
6762815239,1320,8,1320,0,3,1951,650000
6762815385,2870,7,1650,1220,5,1976,646000
6762815660,2807,8,2807,0,4,1996,630000
6762815890,1910,8,1910,0,4,1987,620000
6762815994,2480,9,2480,0,5,1978,615000
6762816789,3250,8,3250,0,4,2008,580000
6762817010,3160,8,3160,0,5,1980,574950
6762817058,2290,8,2290,0,4,1996,570000
6762817145,3260,8,3260,0,5,1969,568450
6762817258,1690,8,1690,0,2,2004,564000
6762817290,2795,8,2795,0,5,1996,562000
6762817403,1240,7,1060,180,2,1938,559000
6762817456,2040,7,1120,920,3,1958,555000
6762817509,1870,8,1170,700,5,1961,554000
6762817816,1560,7,1360,200,3,1936,545500
6762817950,2050,8,2050,0,4,1989,540000
6762817951,1970,8,1420,550,3,1963,540000
6762818084,1930,9,1930,0,3,2013,536751
6762818121,2120,7,2120,0,3,2003,535000
6762818122,2610,8,2610,0,4,2008,535000
6762818714,2920,9,2920,0,4,2003,515500
6762818727,1360,8,1040,320,3,2007,515000
6762818955,3850,9,3030,820,5,2002,507000
6762818956,1770,7,1170,600,4,1968,507000
6762819630,1430,8,1410,20,2,2008,485000
6762819734,1380,8,1380,0,3,2008,482000
6762819942,1700,8,1230,470,3,1977,475000
6762820192,2240,7,1140,1100,5,1966,469000
6762820280,1510,7,860,650,3,1925,465000
6762820418,2770,9,1980,790,3,2006,461000
6762820616,1180,7,1180,0,3,1981,455000
6762820782,1180,6,760,420,3,1928,450000
6762821223,2410,7,2410,0,4,2000,440000
6762821998,1670,7,1170,500,3,1972,424000
6762822282,1270,7,1270,0,3,1952,415000
6762822283,2020,7,2020,0,4,2010,415000
6762822461,1970,8,1820,150,4,1961,410000
6762822584,2310,7,2310,0,4,1968,407450
6762822716,3600,8,2410,1190,5,1968,403500
6762822814,1050,6,950,100,3,1928,400000
6762823548,1689,8,1689,0,3,2008,384400
6762823840,940,6,940,0,2,1910,375000
6762823841,1950,8,1950,0,3,1997,375000
6762824253,2640,8,1680,960,3,1991,365000
6762825243,1100,7,1100,0,2,1954,343566
6762825762,1600,8,1600,0,3,2005,330000
6762826008,2200,7,1280,920,3,1977,325000
6762826201,1820,7,1820,0,4,1994,322500
6762826475,1730,7,1730,0,3,1993,315000
6762826687,2660,8,1740,920,4,1960,310000
6762826795,1490,7,1220,270,3,2010,309000
6762827077,1700,7,1700,0,3,2000,300000
6762827078,910,7,910,0,3,1971,300000
6762827253,2220,7,1110,1110,5,1968,299000
6762827358,1380,7,1380,0,3,1966,295000
6762827684,2570,8,1590,980,4,1979,287500
6762827829,990,7,990,0,3,1960,284950
6762828026,2150,7,1460,690,5,1970,279950
6762828287,1720,8,1320,400,3,1969,274500
6762828569,1584,7,1584,0,3,2012,267000
6762828614,2050,7,1050,1000,4,1963,265000
6762828701,1770,7,1050,720,4,1983,264950
6762828717,1820,7,1080,740,4,1980,264000
6762829111,2030,6,1430,600,4,1947,253779
6762829187,790,6,790,0,2,1942,250275
6762829588,1260,7,1260,0,3,1986,242000
6762829625,670,6,670,0,2,1942,240000
6762829702,1670,7,1170,500,3,1978,239950
6762829953,1080,6,1080,0,2,1958,230000
6762830270,1130,7,1130,0,3,1958,220000
6762830668,1820,7,1820,0,2,1921,206000
6762830963,1080,6,1080,0,3,1900,192500
6762830982,720,6,720,0,1,1914,190000
6762831124,1990,7,1990,0,3,1967,180000
6762831190,660,6,660,0,2,1915,175000
6762831191,1370,6,1120,250,6,1931,175000
6762810183,5990,11,4050,1940,5,2002,2200000
6762810302,3880,10,3880,0,5,1972,1820000
6762810520,3620,11,2350,1270,4,1927,1530000
6762810606,3870,11,2760,1110,3,2002,1440000
6762810750,2440,8,2440,0,4,1902,1330000
6762810782,4750,10,3600,1150,4,2005,1310000
6762810925,3820,10,3280,540,4,1990,1240000
6762811041,3330,11,2610,720,5,1977,1190000
6762811298,3990,11,3990,0,5,2001,1070000
6762811418,2430,9,2430,0,3,1989,1030000
6762811803,2540,9,2540,0,2,2004,945000
6762811871,3530,9,3530,0,5,1925,930000
6762811896,3280,10,3280,0,4,1994,925000
6762812096,2370,8,1440,930,4,1959,899000
6762812460,1590,9,1320,270,2,1927,850000
6762812922,3910,11,3910,0,3,1985,805000
6762813039,2590,9,2590,0,4,2001,799000
6762813285,3010,11,3010,0,4,1996,775000
6762813367,2650,9,2650,0,3,1994,770000
6762813547,2160,7,1080,1080,4,1947,756000
6762813607,3390,10,3040,350,3,2012,750000
6762813874,2650,8,2650,0,4,2012,734990
6762813959,2320,8,2320,0,3,2008,728050
6762814075,2440,9,2440,0,4,1987,720000
6762814209,3200,9,3200,0,3,2004,712000
6762814329,1360,8,1360,0,3,1945,703000
6762814698,1670,7,900,770,6,1911,680000
6762815037,2496,9,2496,0,4,1998,661000
6762815104,2620,8,1870,750,4,1956,659500
6762815386,2310,8,2310,0,4,2008,646000
6762815938,2270,8,1500,770,4,1972,619850
6762815956,2520,8,1550,970,4,1931,618250
6762816156,1530,8,1530,0,3,2006,607500
6762816289,2540,9,2540,0,3,2007,600000
6762816290,3070,8,3070,0,4,1970,600000
6762816547,1470,7,1470,0,3,1907,590300
6762816677,2840,8,2840,0,4,2001,585000
6762816790,2160,8,2160,0,4,1969,580000
6762816908,1940,7,970,970,3,1948,576000
6762817412,2060,8,1320,740,4,1962,558000
6762817759,1290,7,1290,0,4,1906,549000
6762817898,1240,8,1240,0,3,2008,543000
6762817934,3090,8,3090,0,5,2014,540500
6762818596,1940,7,1940,0,3,1991,520000
6762818656,2020,7,1270,750,3,1954,519000
6762818854,2610,8,2610,0,4,1998,510000
6762818957,2120,8,2120,0,3,2003,507000
6762818971,1570,8,1150,420,2,1952,506000
6762818986,1610,8,1610,0,3,1996,505000
6762819086,2840,9,1870,970,3,1994,500000
6762819269,1840,7,920,920,3,1910,499000
6762819553,1820,8,1820,0,3,1983,489950
6762819943,950,8,950,0,3,2003,475000
6762820120,1730,8,1730,0,3,1997,470000
6762820368,1320,7,1320,0,3,1900,464000
6762820783,1610,7,1610,0,3,1955,450000
6762820784,2400,8,2400,0,4,2003,450000
6762821224,1170,7,1170,0,3,1968,440000
6762821407,1440,8,1440,0,2,2005,437000
6762821425,790,6,790,0,2,1949,436000
6762821461,1310,6,1310,0,3,1948,435000
6762821731,2640,8,2640,0,4,1987,429900
6762822462,2520,7,1320,1200,6,1962,410000
6762822635,1260,7,1260,0,2,1947,405000
6762822774,1940,7,1940,0,4,1947,401000
6762822979,1820,7,1320,500,4,1930,399888
6762823107,1980,7,1430,550,4,1968,395000
6762823254,1600,7,1090,510,3,1979,390000
6762823473,2310,8,1630,680,3,1978,385000
6762823635,2150,7,1090,1060,4,1963,380000
6762823770,2160,7,1260,900,3,1909,378750
6762824363,1800,8,1800,0,3,2011,362500
6762824413,2850,8,2850,0,4,2004,360000
6762824799,1430,7,1430,0,3,1945,352450
6762824850,1620,6,850,770,2,1921,350000
6762825113,2140,8,1480,660,3,1966,346150
6762825318,2480,7,2480,0,3,2004,340000
6762825564,2030,7,2030,0,4,1969,335000
6762825763,2238,8,2238,0,3,2011,330000
6762826254,3490,8,3490,0,4,2003,320000
6762826352,920,7,920,0,2,1939,319950
6762826657,1900,7,1070,830,3,1903,311000
6762826688,1220,6,1220,0,4,1980,310000
6762827696,1300,7,1300,0,3,1933,287000
6762827764,1210,7,1210,0,3,1901,285000
6762827931,1790,7,1790,0,3,1990,280000
6762828174,1860,7,1860,0,3,1971,275000
6762828486,1530,7,1530,0,4,1968,269900
6762828615,1840,8,1840,0,3,1966,265000
6762829350,1050,7,1050,0,3,1959,249000
6762829385,2080,7,1040,1040,4,1950,248000
6762829626,1790,7,1670,120,4,1960,240000
6762829913,1750,7,1750,0,3,1976,232603
6762829914,1320,6,880,440,3,1961,232500
6762830252,1640,7,1140,500,3,1984,221000
6762830544,1440,8,1440,0,3,1983,210000
6762830786,1140,7,1140,0,3,1960,200000
6762830886,1330,7,1330,0,3,1905,197500
6762831049,1340,5,920,420,3,1912,186000
6762831172,1150,7,1150,0,3,1983,177000
6762831550,990,4,990,0,2,1945,120000
6762810138,5480,9,4430,1050,6,1999,2400000
6762810207,3230,9,3230,0,3,1973,2110000
6762810241,4640,11,2860,1780,7,1965,1950000
6762810582,3840,10,2750,1090,5,2008,1460000
6762810751,2870,9,1980,890,4,1905,1330000
6762810769,4410,11,4410,0,4,1989,1320000
6762810799,3366,8,2966,400,5,1937,1300000
6762810926,6630,10,4930,1700,7,2004,1240000
6762810945,3240,9,2500,740,5,1939,1230000
6762811143,6900,9,4820,2080,6,2002,1140000
6762811269,4910,10,4000,910,3,1989,1080000
6762811536,3850,10,3000,850,4,1998,995000
6762811614,1700,8,1700,0,3,1954,979000
6762811651,2470,8,2470,0,3,1960,970500
6762811751,3360,9,3360,0,4,1988,950000
6762811752,3050,8,1650,1400,3,1962,950000
6762811897,3140,8,2040,1100,4,1959,925000
6762811898,3730,10,3730,0,4,2012,925000
6762811973,2660,9,2170,490,3,2003,915000
6762812031,2970,9,2340,630,4,1997,905000
6762812186,2060,9,1610,450,3,1975,885000
6762812320,3740,9,3060,680,4,1988,869000
6762812461,2870,10,2250,620,3,1995,850000
6762812668,2780,9,2780,0,5,1978,830000
6762812851,3240,9,3240,0,3,2001,812000
6762812970,3150,9,3150,0,4,2004,800000
6762813108,2050,8,1450,600,4,1974,790000
6762813214,2140,9,2140,0,3,1905,780000
6762813280,2970,8,2970,0,4,2014,775950
6762813568,2770,8,2770,0,2,2006,754800
6762813985,3940,9,3440,500,4,2000,725000
6762813986,2380,8,2380,0,6,1917,725000
6762813987,3690,10,3690,0,3,2001,725000
6762814155,3290,9,3290,0,4,2003,715000
6762814688,3260,8,1630,1630,5,1964,681500
6762814965,2870,8,2220,650,4,1926,665900
6762815056,3030,8,3030,0,4,1988,660000
6762815182,1530,8,1280,250,3,2005,654000
6762815240,3040,7,3040,0,4,2003,650000
6762815471,1760,7,880,880,2,1930,640000
6762815634,2090,10,2090,0,4,1986,632500
6762815759,2440,10,2440,0,3,2014,625000
6762815853,1850,8,1850,0,3,1989,623000
6762816188,2620,8,2620,0,4,1996,605000
6762816291,1040,7,1040,0,2,1919,600000
6762816468,3290,8,3290,0,3,1993,595000
6762816651,1890,8,1640,250,3,1999,587206
6762817191,3260,9,3260,0,4,2013,565000
6762817794,2200,7,1420,780,5,1916,547000
6762818423,1750,8,1750,0,3,2001,525000
6762818836,1360,7,1360,0,4,1917,511500
6762819568,2120,7,1060,1060,4,1940,489000
6762819580,2170,8,1300,870,4,1976,488800
6762819727,1630,7,1110,520,4,1990,482500
6762819771,2080,7,1040,1040,4,1941,480000
6762819894,1780,7,1210,570,3,1976,477000
6762820558,1870,8,1870,0,3,2003,458000
6762820592,1440,7,1440,0,3,1975,456000
6762820617,1470,7,1470,0,3,1985,455000
6762820618,2450,8,1650,800,4,1954,455000
6762820785,1430,7,980,450,3,1947,450000
6762820995,2510,9,2510,0,4,2006,448000
6762821137,2040,8,2040,0,4,1994,443500
6762821191,1910,7,1160,750,3,1979,441000
6762821420,3110,8,1790,1320,5,1977,436500
6762821847,2540,9,2540,0,3,1999,425000
6762821848,1790,7,1290,500,3,1967,425000
6762822063,2280,8,1300,980,5,1959,420000
6762822064,2630,8,1670,960,5,2013,420000
6762822415,1260,6,690,570,2,1925,412000
6762822636,1460,7,1460,0,3,2002,405000
6762822815,1430,7,1430,0,3,1950,400000
6762822816,2670,8,2670,0,4,1972,400000
6762822817,2420,7,1400,1020,4,1973,400000
6762823059,2320,8,2320,0,4,1997,397000
6762823108,1500,6,900,600,3,1925,395000
6762823255,1160,7,1160,0,3,1910,390000
6762823636,1520,7,1020,500,3,1949,380000
6762823778,1890,7,1230,660,4,1978,378000
6762824035,2550,8,2550,0,4,2005,371000
6762824503,1940,8,1100,840,3,1981,359950
6762824520,2290,7,1290,1000,5,1973,359900
6762824642,2040,7,2040,0,4,1996,355000
6762824643,1240,6,1000,240,2,1943,355000
6762825319,1880,7,1330,550,3,1985,340000
6762825417,2570,8,2570,0,3,2014,339990
6762825502,2240,7,2240,0,4,1992,337000
6762825721,1510,6,1510,0,3,1942,332000
6762825764,1860,7,1860,0,3,1995,330000
6762825871,1820,7,1820,0,3,1983,329950
6762826009,840,7,840,0,2,1948,325000
6762827510,1860,7,1140,720,3,1967,291000
6762827880,1890,7,1890,0,4,1997,282000
6762827932,1470,7,1470,0,3,1987,280000
6762828051,2200,7,1100,1100,4,1979,279000
6762828702,1810,7,1410,400,4,1959,264950
6762829210,800,6,680,120,1,1931,250000
6762829463,380,5,380,0,1,1963,245000
6762829763,1300,7,1300,0,3,1960,237000
6762830363,1310,6,1310,0,2,2004,218000
6762830420,1960,6,980,980,4,1931,215000
6762830545,1680,7,1680,0,2,1910,210000
6762830685,960,6,960,0,3,1960,205000
6762830740,1150,6,1150,0,3,1953,203000
6762830787,1230,7,1230,0,3,1913,200000
6762830788,860,6,860,0,2,1949,200000
6762831192,1020,6,1020,0,2,1948,175000
6762811212,2200,7,1400,800,3,1952,1100000
6762811872,3290,10,3290,0,3,2000,930000
6762812519,2160,8,2160,0,4,1928,849000
6762813608,2610,8,1680,930,3,1934,750000
6762815518,2330,8,2330,0,4,1986,639500
6762821154,1780,6,890,890,4,1943,442900
6762822207,1550,7,1000,550,4,1956,418000
6762823842,1230,7,830,400,2,1948,375000
6762812281,3530,10,2570,960,4,1987,874150
6762812864,2810,9,2810,0,4,1989,810000
6762812955,2870,8,1840,1030,3,1907,802000
6762813892,2130,7,1230,900,4,1963,732600
6762814617,2370,8,2370,0,4,1966,687000
6762817192,1330,7,960,370,2,1914,565000
6762817829,2090,8,2090,0,4,1990,545000
6762819087,2040,8,1420,620,4,1963,500000
6762819772,1490,8,1490,0,2,1926,480000
6762821333,2050,8,1570,480,3,1977,439500
6762823982,2580,7,2580,0,4,2004,374000
6762825765,2380,7,2380,0,4,1999,330000
6762810043,5230,10,3740,1490,3,2005,3400000
6762810210,4230,11,4230,0,4,1997,2080000
6762810367,2810,10,2810,0,3,1974,1700000
6762810474,4570,12,4570,0,4,1948,1580000
6762810830,2190,8,1550,640,3,1956,1290000
6762810967,3520,8,2200,1320,4,1913,1220000
6762811042,3160,10,3160,0,4,1965,1190000
6762812032,3440,11,3440,0,4,2006,905000
6762812033,3500,10,2570,930,5,1996,905000
6762812097,1480,8,1480,0,3,1949,899000
6762812619,3030,10,3030,0,4,1998,835000
6762812658,4470,11,4470,0,5,1984,831500
6762812916,2500,10,2500,0,4,1997,806000
6762812971,2380,9,1450,930,3,1972,800000
6762812972,3520,8,1980,1540,4,1954,800000
6762813215,3910,10,2490,1420,4,1987,780000
6762813286,2300,9,2300,0,4,1999,775000
6762813609,1820,8,1720,100,3,1941,750000
6762813850,2270,8,1340,930,4,1954,735000
6762813988,1610,7,1610,0,3,1962,725000
6762813989,3420,9,3420,0,4,1988,725000
6762814156,2650,8,1680,970,4,1960,715000
6762814547,970,7,970,0,2,1907,690000
6762814633,1300,7,1300,0,2,1943,685000
6762814802,2810,9,2810,0,4,1982,675000
6762814898,3310,8,2440,870,3,2008,670000
6762815013,3190,9,1890,1300,5,2013,664950
6762815057,1980,7,1980,0,3,1987,660000
6762815241,2400,9,2400,0,4,1990,650000
6762815344,1500,9,1200,300,3,2014,649950
6762815355,2260,9,1890,370,2,2005,649000
6762815625,2960,9,2960,0,4,2014,633634
6762815995,2130,7,1270,860,5,1926,615000
6762816244,2660,8,1550,1110,6,1962,603500
6762816292,2260,10,2260,0,3,1987,600000
6762816552,3220,8,3220,0,4,1966,590000
6762816862,1640,8,1640,0,3,2009,579000
6762816894,2060,7,1330,730,3,1976,577000
6762817135,1730,7,1060,670,4,1924,569000
6762817279,1300,8,1000,300,3,2006,562500
6762817327,1960,8,1960,0,3,1989,560000
6762817328,2300,9,2300,0,4,1990,560000
6762817588,1900,8,1900,0,3,1988,550000
6762817589,1840,8,1840,0,3,1964,550000
6762818424,1080,7,1080,0,2,1924,525000
6762818728,2910,8,2040,870,5,2013,515000
6762819049,2890,8,1630,1260,6,1977,502000
6762819088,1150,8,1150,0,3,1911,500000
6762819314,1630,7,1630,0,3,2005,497000
6762819354,2950,7,2310,640,3,1918,495000
6762819420,1830,8,1540,290,4,1973,494000
6762819454,1540,8,1540,0,4,2014,491234
6762819475,1470,8,1080,390,3,1984,490000
6762819859,2110,8,2110,0,3,1978,479000
6762820097,1800,7,900,900,3,1905,471001
6762820121,2150,8,2150,0,3,1992,470000
6762820443,3390,8,1750,1640,5,1978,460000
6762820512,2000,8,2000,0,4,2003,459950
6762820547,1890,9,1430,460,3,2012,458500
6762820699,2120,7,1060,1060,4,1956,453000
6762820786,2160,8,1260,900,4,1942,450000
6762820963,1780,7,1340,440,3,1972,449500
6762820972,1850,7,1230,620,4,1930,449000
6762821035,2550,7,1610,940,2,1958,446000
6762821159,1600,7,1050,550,3,1977,442500
6762821175,2520,9,2520,0,4,1990,442000
6762821225,1560,7,1250,310,3,1983,440000
6762821648,950,7,950,0,2,1949,430000
6762821649,1300,8,1300,0,3,1981,430000
6762821849,880,7,880,0,2,1950,425000
6762821850,1580,7,1180,400,3,1992,425000
6762822065,1200,6,880,320,3,1937,420000
6762822284,2170,7,1350,820,4,1955,415000
6762822637,860,6,860,0,2,1901,405000
6762822638,1520,8,1520,0,3,2004,405000
6762822717,1830,8,1200,630,3,1960,403500
6762822746,1020,7,1020,0,2,2009,402101
6762822818,1700,7,1340,360,4,1965,400000
6762822943,1560,7,810,750,3,1940,399950
6762823077,2390,8,1350,1040,3,1955,396500
6762823367,1880,7,1880,0,3,1959,389800
6762823474,1630,8,1630,0,3,2007,385000
6762823475,2700,9,2700,0,4,1984,385000
6762823843,1870,8,1870,0,4,1990,375000
6762824254,1940,8,1940,0,4,1962,365000
6762824364,940,7,940,0,2,2009,362500
6762824372,2430,8,2430,0,3,1997,362300
6762824414,1720,7,1720,0,4,1953,360000
6762824851,2800,7,1400,1400,7,1963,350000
6762824852,1660,7,1660,0,3,1957,350000
6762825030,2420,7,1210,1210,3,1949,349900
6762825095,1270,7,1270,0,3,1955,347000
6762825117,1270,6,880,390,3,1950,346000
6762825123,2110,8,2110,0,3,1989,345950
6762825129,1950,8,1360,590,3,1959,345100
6762825145,1140,7,1140,0,3,1904,345000
6762825146,1420,8,1140,280,3,2008,345000
6762825503,1310,7,1310,0,3,1993,337000
6762825565,720,6,720,0,1,1907,335000
6762825669,1150,6,1150,0,4,1970,334000
6762825890,2242,8,2242,0,3,2011,329900
6762825977,1030,7,1030,0,3,1969,326000
6762826172,2110,8,1170,940,4,1975,324000
6762826210,2010,8,2010,0,4,1975,322200
6762826255,2280,8,2280,0,3,1998,320000
6762826256,1890,8,1890,0,4,1974,320000
6762826616,2300,8,2300,0,5,2013,312891
6762826689,2540,7,2540,0,3,2006,310000
6762827079,2620,7,2620,0,4,2008,300000
6762827080,1840,8,1840,0,4,2004,300000
6762827194,1060,6,1060,0,2,1951,299995
6762827505,880,6,880,0,3,1946,291500
6762827520,1610,6,1610,0,2,1930,290900
6762827534,1150,6,990,160,3,1932,290000
6762827728,1100,7,780,320,3,2008,286000
6762827765,1660,8,1660,0,3,2003,285000
6762827933,1010,7,1010,0,2,1925,280000
6762828175,1180,6,1180,0,2,1949,275000
6762828176,1080,7,1080,0,3,1952,275000
6762828467,2540,7,2540,0,4,1977,269950
6762828493,1840,7,1240,600,3,1976,269500
6762828616,1620,7,1620,0,3,1928,265000
6762828718,1760,8,1760,0,3,1966,264000
6762828775,1390,7,1390,0,3,1962,261350
6762828801,2000,8,2000,0,4,1989,260000
6762829334,1310,7,1310,0,3,1990,249900
6762829344,1500,7,1500,0,2,1963,249500
6762829351,1000,7,1000,0,3,1968,249000
6762829703,1230,7,1230,0,3,1984,239950
6762829802,1170,6,1170,0,3,1968,235000
6762829803,2180,7,2180,0,6,1980,235000
6762829804,1450,7,1180,270,4,1962,235000
6762829885,870,6,870,0,2,1940,234000
6762829901,1650,7,1650,0,3,1985,233500
6762829954,1530,7,1530,0,3,1919,230000
6762830133,1580,7,1580,0,3,1967,225000
6762830421,1340,6,1340,0,3,1931,215000
6762830681,880,6,880,0,2,1945,205425
6762830789,1090,7,1090,0,3,1968,200000
6762830840,1740,7,1740,0,5,1959,199950
6762831298,1200,6,1200,0,3,1943,165000
6762831335,1270,7,1270,0,3,2012,160797
6762810062,4550,10,2600,1950,4,2002,3080000
6762810095,3831,9,3831,0,5,1959,2700000
6762810126,6390,10,4560,1830,5,1940,2470000
6762810892,3220,9,1680,1540,4,1973,1250000
6762810968,3820,10,3820,0,4,1994,1220000
6762811089,2740,10,2740,0,3,1913,1160000
6762811457,1460,6,1460,0,2,1900,1010000
6762811523,2420,9,2420,0,4,1973,998000
6762811654,3060,9,1810,1250,3,1930,970000
6762811813,2320,8,1820,500,4,1926,941000
6762811899,3580,10,3580,0,4,1985,925000
6762812209,3030,9,3030,0,4,2005,880000
6762812249,3220,10,3220,0,4,1996,875000
6762812398,3550,8,1830,1720,4,2010,859000
6762812462,3920,10,3920,0,4,1996,850000
6762812463,3330,8,1790,1540,4,1958,850000
6762812538,2540,9,1840,700,3,1930,845000
6762812600,3200,10,3200,0,3,2000,839000
6762812798,2130,8,1530,600,3,1908,819000
6762813109,3190,9,3190,0,4,2010,790000
6762813457,2610,8,1760,850,4,1978,762500
6762813590,3090,9,2370,720,4,2004,751000
6762813728,2440,8,2440,0,4,2013,745641
6762813990,2650,8,2650,0,4,1986,725000
6762814590,2200,8,1500,700,3,1978,689000
6762814609,2330,7,1510,820,4,1929,687500
6762814673,1820,7,1640,180,3,1946,683500
6762814803,2300,8,2300,0,3,2004,675000
6762814974,2840,8,1420,1420,6,1961,665000
6762815058,2550,7,1860,690,2,1902,660000
6762815472,2341,9,2341,0,4,1997,640000
6762815517,2050,8,2050,0,4,2012,639888
6762815644,1130,8,1130,0,2,1927,631500
6762815760,2410,8,1820,590,3,1976,625000
6762815891,2450,9,2450,0,4,1994,620000
6762815996,1270,8,1090,180,2,1949,615000
6762815997,1720,7,960,760,3,1924,615000
6762816293,1740,7,1740,0,4,1968,600000
6762816294,4690,10,3680,1010,4,1995,600000
6762816411,2730,7,2080,650,5,1968,599000
6762816603,3190,10,3190,0,4,2006,589950
6762816678,2270,8,2270,0,3,1998,585000
6762816929,4620,11,4620,0,4,1991,575000
6762816930,2400,7,1440,960,3,1926,575000
6762817760,2034,7,1159,875,2,1947,549000
6762818123,2070,8,2070,0,3,1999,535000
6762818254,1580,8,1280,300,2,1941,530000
6762818597,2300,9,2300,0,3,1984,520000
6762818670,2520,9,2520,0,4,1999,518000
6762818855,1420,8,1420,0,3,2006,510000
6762819050,1300,7,1300,0,3,1955,502000
6762819631,1500,7,900,600,3,1920,485000
6762819719,1240,7,1240,0,2,1906,483000
6762820361,1150,7,1150,0,3,1959,464500
6762820567,1430,8,980,450,3,1996,457500
6762820619,2950,7,2950,0,4,2005,455000
6762820620,1200,8,1000,200,2,2015,455000
6762821064,1250,6,1250,0,4,1959,445000
6762821226,2000,8,1480,520,3,1957,440000
6762821373,1520,7,790,730,3,1948,438000
6762821408,1890,8,1290,600,4,1980,437000
6762821851,1930,8,1930,0,3,1990,425000
6762821852,1600,6,1600,0,4,1946,425000
6762822066,2140,8,2140,0,3,2005,420000
6762822285,1070,7,1070,0,3,1977,415000
6762822286,2280,8,2280,0,3,2011,415000
6762822639,3170,10,2360,810,3,1995,405000
6762822640,1310,7,1310,0,3,1957,405000
6762822641,1410,7,1410,0,3,1951,405000
6762822819,1230,7,990,240,3,1984,400000
6762822820,2970,7,1510,1460,3,1967,400000
6762823078,2590,10,2590,0,3,1976,396500
6762823109,1540,6,770,770,4,1943,395000
6762823110,1600,7,1600,0,3,2007,395000
6762823637,1860,7,1860,0,3,1963,380000
6762823752,1740,8,1740,0,3,1992,379000
6762824204,1660,7,1160,500,3,1978,367500
6762824229,1840,8,1340,500,3,1977,366000
6762824365,1450,7,1450,0,4,1960,362500
6762824415,1500,7,1500,0,3,1957,360000
6762824561,1810,7,1810,0,3,1969,358000
6762824644,930,8,630,300,2,2007,355000
6762824853,740,6,740,0,2,1922,350000
6762824854,2560,9,2560,0,4,2004,350000
6762825009,2090,8,2090,0,4,1989,349950
6762825060,1360,7,1360,0,3,1966,348500
6762825244,1760,7,1180,580,4,1950,343500
6762825265,1210,7,1210,0,2,1982,342500
6762825449,2470,6,1970,500,4,1948,339000
6762825450,1100,7,720,380,3,1942,339000
6762825523,1480,7,970,510,3,1963,336500
6762825872,900,6,900,0,2,1956,329950
6762825903,830,7,830,0,2,2005,329445
6762826010,850,6,850,0,3,1948,325000
6762826141,1460,7,1460,0,3,1955,324950
6762826373,2510,8,1610,900,4,1978,319000
6762826422,2360,7,1180,1180,5,1962,317000
6762826581,2700,7,1380,1320,4,1958,314900
6762826897,2210,8,2210,0,4,1968,305000
6762826990,1310,7,1310,0,4,1953,304000
6762827081,2150,6,2150,0,3,1954,300000
6762827082,750,6,750,0,2,1941,300000
6762827359,650,6,650,0,2,1950,295000
6762827360,2000,7,1300,700,3,1968,295000
6762827646,1970,7,1090,880,3,1988,289000
6762828177,990,7,990,0,3,1968,275000
6762828932,1490,7,1120,370,3,1969,258000
6762828947,1180,7,1180,0,2,1940,257500
6762829148,1670,7,1190,480,3,1977,252000
6762829778,2000,7,2000,0,4,1997,236000
6762829955,1850,6,1270,580,4,1944,230000
6762830134,1330,7,1330,0,3,1968,225000
6762830364,880,6,880,0,3,1945,218000
6762830365,1330,7,1330,0,3,1968,218000
6762830546,970,7,970,0,2,1956,210000
6762830864,1000,6,1000,0,3,1991,199000
6762830946,1050,7,1050,0,3,1983,194000
6762831341,1010,7,1010,0,3,1962,160000
6762831489,690,5,690,0,2,1942,139000
6762810155,4250,9,4250,0,4,2004,2300000
6762810368,5850,11,4670,1180,5,1978,1700000
6762810705,2680,8,1880,800,3,1913,1360000
6762810752,1940,8,1940,0,3,1900,1330000
6762810845,4660,11,4660,0,4,2003,1280000
6762810946,3770,10,2830,940,4,1989,1230000
6762811002,3990,11,3990,0,4,2006,1200000
6762811110,2110,7,2110,0,3,1979,1150000
6762811144,3310,9,3310,0,4,1924,1140000
6762811299,3370,10,3370,0,5,2001,1070000
6762811458,4225,11,4225,0,4,1985,1010000
6762811537,4380,9,3720,660,3,1968,995000
6762811625,2620,10,2620,0,5,2009,975000
6762811723,3160,10,2180,980,5,2005,957000
6762811991,2370,9,2370,0,5,1981,913888
6762812034,3100,9,1660,1440,5,1970,905000
6762812152,2550,8,2370,180,4,1905,890000
6762812298,2840,8,1960,880,4,1912,870000
6762812377,4500,8,3000,1500,5,1968,860000
6762812943,3070,10,3070,0,4,2005,804100
6762812973,1740,8,1740,0,2,1955,800000
6762813368,3920,10,3920,0,4,1997,770000
6762813466,4000,9,4000,0,4,2007,762000
6762813481,2760,7,2230,530,4,1942,760000
6762813610,1840,7,1340,500,3,1915,750000
6762813749,2700,8,1750,950,5,1967,744500
6762813774,3000,9,3000,0,4,1995,740000
6762813808,2980,9,2980,0,5,2006,739900
6762813991,2610,9,2610,0,3,1996,725000
6762813992,2490,9,2490,0,4,2000,725000
6762814355,2770,9,2770,0,4,2004,700000
6762814538,2000,7,1280,720,5,1908,690500
6762814699,1880,8,1440,440,4,1954,680000
6762815059,2210,8,2210,0,3,2008,660000
6762815134,2180,7,1420,760,4,1926,657000
6762815242,1910,7,1420,490,4,1940,650000
6762815395,1850,8,1850,0,3,1953,645000
6762815473,1620,7,1040,580,33,1947,640000
6762815761,2700,8,1950,750,5,1955,625000
6762816145,2690,7,2690,0,4,2001,608000
6762816386,2680,8,1570,1110,3,1978,599990
6762816451,3570,10,2860,710,4,2015,597326
6762816462,1870,9,1870,0,3,1958,595888
6762816513,1270,8,1060,210,3,2014,594000
6762816514,2720,9,2720,0,4,2005,594000
6762816604,2790,7,1500,1290,5,1973,589950
6762816679,2890,8,1560,1330,4,1973,585000
6762816750,1790,8,1790,0,3,1989,583000
6762816881,2070,8,2070,0,4,1996,578000
6762816931,1700,7,1100,600,3,1924,575000
6762817013,2380,8,2380,0,3,2002,574000
6762817193,1670,9,1670,0,2,2005,565000
6762817266,1400,8,1400,0,3,2007,563500
6762817287,1440,7,1200,240,2,1914,562100
6762817422,1900,7,1900,0,3,1959,557500
6762817888,2030,8,2030,0,4,1994,544000
6762818228,3110,8,3110,0,4,1958,531500
6762818255,2140,7,1070,1070,5,1962,530000
6762818657,1950,7,1250,700,4,1910,519000
6762818987,1860,8,1860,0,3,1987,505000
6762818988,1640,8,1640,0,3,1975,505000
6762819089,1190,7,970,220,3,1940,500000
6762819735,2420,7,2420,0,3,1998,482000
6762820527,2640,7,2640,0,5,2001,459000
6762820685,1970,7,1970,0,3,1970,454000
6762820787,2330,8,1330,1000,3,1954,450000
6762820788,2310,8,1330,980,4,1952,450000
6762820789,1380,8,880,500,2,1931,450000
6762821227,2030,7,2030,0,3,1953,440000
6762821462,1060,6,1060,0,2,1943,435000
6762821853,2320,8,2320,0,3,2009,425000
6762822196,2100,7,1290,810,4,1973,418800
6762822463,1250,7,1250,0,3,1968,410000
6762822545,1590,9,1590,0,2,1997,409900
6762822753,2000,7,1650,350,4,1926,402000
6762822821,2180,7,1420,760,3,1962,400000
6762823111,1350,8,1050,300,2,2007,395000
6762823256,2340,8,2340,0,4,1993,390000
6762823445,2050,8,1770,280,4,1965,386000
6762823565,1500,7,1500,0,3,1977,383000
6762823605,900,7,900,0,2,1924,381500
6762823975,1400,8,1400,0,3,1984,374500
6762824240,1410,7,1410,0,3,1983,365500
6762824336,1800,8,1800,0,3,2011,364000
6762824616,2020,7,2020,0,4,1949,356000
6762824802,1530,7,980,550,4,1925,352000
6762825046,1010,6,1010,0,3,1947,349000
6762825106,1610,7,1010,600,2,1941,346500
6762825107,1150,7,1150,0,3,1932,346500
6762825766,3040,8,1890,1150,6,1951,330000
6762825927,1730,8,1730,0,3,2014,328423
6762826257,2000,7,2000,0,4,1997,320000
6762826476,1780,6,930,850,4,1918,315000
6762826690,870,6,870,0,2,1950,310000
6762826788,1860,8,1860,0,3,2012,309620
6762826814,1640,6,1640,0,3,1942,308000
6762826898,1900,7,1200,700,6,1964,305000
6762827201,1870,7,1870,0,3,1990,299950
6762827202,1790,9,1790,0,3,1978,299950
6762827222,1110,7,1110,0,3,1979,299900
6762827671,1150,7,1150,0,3,2007,288000
6762827729,780,5,780,0,2,1930,286000
6762827766,1460,7,1460,0,3,1995,285000
6762827861,890,6,890,0,3,1954,283000
6762827934,1230,7,1230,0,3,1966,280000
6762827935,1940,7,1940,0,7,1994,280000
6762828132,1270,7,1270,0,3,1958,276900
6762828142,2460,8,2460,0,4,1959,276000
6762828178,770,7,770,0,2,1927,275000
6762828391,1670,7,1300,370,3,1990,270000
6762828392,2060,7,1260,800,2,1962,270000
6762828599,1150,6,1150,0,3,1951,265950
6762828802,1120,6,1120,0,2,1944,260000
6762828803,1580,7,1140,440,3,1954,260000
6762828804,2025,7,2025,0,5,2007,260000
6762828995,1720,7,1720,0,3,1992,255950
6762829352,1830,7,1830,0,4,1990,249000
6762829430,1620,7,1620,0,3,1989,246500
6762829448,1640,8,1180,460,3,1968,245700
6762829464,1410,7,1410,0,3,1985,245000
6762829627,1481,7,1481,0,3,2012,240000
6762829805,1570,7,1570,0,4,1984,235000
6762829903,1250,7,1250,0,3,1955,233000
6762830686,1050,7,1050,0,3,1958,205000
6762830687,1230,6,1230,0,3,1965,205000
6762830790,1150,6,1150,0,3,1938,200000
6762830791,1190,7,1190,0,3,1995,200000
6762830897,1320,7,1320,0,3,1966,196500
6762830983,930,6,930,0,1,1941,190000
6762831412,1090,6,1090,0,3,1969,152000
6762831427,890,6,890,0,2,1942,150000
6762810229,4480,12,3420,1060,5,1902,1990000
6762810630,3250,9,3250,0,4,1979,1410000
6762810667,4040,9,2020,2020,4,1972,1390000
6762810668,2480,10,1730,750,3,1950,1390000
6762810739,3190,10,2160,1030,4,2003,1340000
6762810893,3760,10,3060,700,3,1910,1250000
6762811111,2490,8,1670,820,3,1918,1150000
6762811270,3990,10,3990,0,4,2008,1080000
6762811344,3450,10,3450,0,4,2007,1050000
6762811419,3320,10,2040,1280,4,1977,1030000
6762811649,3460,11,3460,0,4,2013,971971
6762811838,2450,8,1750,700,3,1915,937000
6762812003,4040,11,4040,0,4,1987,910000
6762812061,3370,8,2470,900,4,2008,900000
6762812232,4230,10,4230,0,4,1985,879000
6762812702,3230,9,1870,1360,4,1977,827000
6762812705,3060,9,3060,0,4,2006,826000
6762812819,2270,9,2270,0,3,1968,815000
6762812820,2620,8,1310,1310,4,1949,815000
6762812923,2600,8,1600,1000,3,1929,805000
6762812974,2080,7,2080,0,3,1958,800000
6762812975,2990,11,2990,0,4,1990,800000
6762813192,3060,10,2300,760,4,2014,782900
6762813287,2850,9,1920,930,3,1976,775000
6762813346,2660,7,2660,0,4,1955,772650
6762813482,1980,7,1980,0,3,1959,760000
6762813554,2880,9,2100,780,4,1912,755000
6762813611,1750,8,1750,0,4,1903,750000
6762813993,3110,7,1810,1300,6,1921,725000
6762814228,3740,11,3100,640,3,1990,710000
6762814491,2590,10,2590,0,3,1993,695000
6762814548,2720,8,1860,860,5,1993,690000
6762814785,2770,9,2770,0,4,1989,675750
6762814899,1490,7,1490,0,3,1906,670000
6762814930,2670,9,2670,0,4,1996,669950
6762814936,1950,6,1160,790,2,1952,669000
6762814952,3320,8,2260,1060,3,1933,667000
6762815023,2480,8,2480,0,3,1974,663000
6762815024,1480,7,860,620,3,1928,663000
6762815060,1210,8,1210,0,3,1955,660000
6762815535,1660,7,970,690,3,1922,638000
6762815738,2430,7,1760,670,3,1945,626000
6762815892,3600,8,2740,860,6,2004,620000
6762815893,2460,8,2460,0,3,1988,620000
6762816295,3240,8,2910,330,3,2004,600000
6762816791,1720,8,1420,300,4,1975,580000
6762816932,3690,9,2690,1000,5,1960,575000
6762817149,2110,8,2110,0,4,1979,568000
6762817267,2085,7,1610,475,4,1964,563500
6762817329,2480,7,1510,970,4,1959,560000
6762817457,3640,8,3640,0,5,2004,555000
6762817590,2150,8,2150,0,4,1997,550000
6762818073,2410,7,2410,0,3,1942,537000
6762818256,2330,8,2330,0,3,1987,530000
6762818425,3030,8,3030,0,4,2011,525000
6762818664,1590,8,1590,0,3,2010,518500
6762819355,1440,8,1440,0,3,1983,495000
6762819918,1520,8,1520,0,3,1983,475580
6762820101,1240,7,1240,0,2,1924,471000
6762820444,1730,7,1210,520,3,1969,460000
6762820445,2550,7,1300,1250,4,1961,460000
6762820753,2830,7,2830,0,5,1967,451000
6762820790,1530,7,1530,0,3,1952,450000
6762820791,840,6,700,140,2,1912,450000
6762821036,1370,8,1080,290,2,2008,446000
6762821228,1770,7,1770,0,4,1947,440000
6762821229,2160,7,1390,770,4,1976,440000
6762821230,2120,8,1220,900,3,1949,440000
6762821231,2250,8,2250,0,4,1989,440000
6762821463,2110,7,1510,600,4,1962,435000
6762821732,2370,8,2370,0,3,2009,429900
6762821999,2100,8,2100,0,4,1965,424000
6762822067,1444,7,1444,0,3,2008,420000
6762822287,1170,8,1170,0,3,1957,415000
6762822386,2490,8,2490,0,3,2012,414000
6762822642,2220,7,2220,0,4,2001,405000
6762822754,620,6,620,0,2,1911,402000
6762822991,3060,8,3060,0,4,2001,399000
6762823257,1370,8,1100,270,3,2006,390000
6762823476,3200,8,1610,1590,4,1970,385000
6762824060,2380,7,1850,530,3,1961,370000
6762824255,2280,6,2280,0,5,1924,365000
6762824534,1940,7,1940,0,5,1953,359000
6762824562,2450,7,2450,0,3,1967,358000
6762824592,1400,6,1400,0,3,1952,357250
6762824721,2530,8,1280,1250,4,1977,354950
6762824730,2580,8,2580,0,4,2005,354000
6762824855,1780,8,1780,0,3,1987,350000
6762825451,950,7,950,0,2,1941,339000
6762825660,1769,9,1769,0,3,2012,334888
6762825743,1930,7,1200,730,4,2006,330675
6762825873,1750,7,1150,600,3,1956,329950
6762826258,950,7,950,0,2,1948,320000
6762826259,1550,7,1550,0,3,1999,320000
6762826477,1940,8,1140,800,4,1977,315000
6762826691,2430,8,2430,0,4,2002,310000
6762827029,1530,7,1530,0,4,1968,302000
6762827083,1780,8,1780,0,3,1967,300000
6762827535,930,6,930,0,2,1924,290000
6762827636,2260,7,2260,0,4,1984,289659
6762827767,1010,7,1010,0,2,1975,285000
6762827905,2070,8,2070,0,4,1977,280927
6762828038,1580,7,1580,0,3,1988,279900
6762828393,2600,7,1600,1000,4,1965,270000
6762828394,1780,9,1780,0,2,1954,270000
6762828534,1650,7,1650,0,3,1991,268000
6762828570,1090,7,1090,0,3,1967,267000
6762829094,1470,7,1470,0,3,1968,254600
6762829101,2080,7,1740,340,5,1959,254000
6762829114,1640,7,1090,550,3,1954,253500
6762829135,1230,7,1230,0,4,1944,252750
6762829138,1900,7,1900,0,3,1991,252500
6762829335,1630,7,1120,510,3,1978,249900
6762829562,1140,6,1140,0,3,1981,243800
6762829628,1200,7,1200,0,4,1933,240000
6762829784,1330,5,1330,0,4,1942,235867
6762829806,2500,7,1300,1200,5,1979,235000
6762829956,1060,7,1060,0,3,1956,230000
6762830115,1590,7,1590,0,2,1972,225500
6762830135,1700,6,970,730,3,1945,225000
6762830210,1600,7,1600,0,4,1959,224000
6762830211,1500,6,1500,0,3,2014,224000
6762830271,1660,7,1660,0,3,1981,220000
6762830337,1090,5,1090,0,3,1912,219500
6762830392,1390,8,1390,0,2,1980,216500
6762830547,720,6,720,0,2,1943,210000
6762830756,920,6,920,0,2,1950,202000
6762830775,1260,7,1260,0,3,1963,200500
6762831171,1220,7,1220,0,3,1968,177500
6762831315,1570,7,1080,490,3,1956,164950
6762831428,1310,7,960,350,3,1962,150000
6762810303,6640,12,6640,0,4,1993,1820000
6762810434,3900,10,2520,1380,4,1972,1620000
6762811003,3650,9,2750,900,5,1969,1200000
6762811345,4390,10,3320,1070,4,2003,1050000
6762811439,1670,8,1670,0,3,1903,1020000
6762811592,3610,9,3610,0,4,2014,982000
6762813555,3260,8,2310,950,5,1950,755000
6762813612,3190,10,2300,890,4,1984,750000
6762813828,2630,9,2630,0,3,2006,738000
6762813851,2370,7,1650,720,4,1916,735000
6762813852,1490,9,1040,450,3,2011,735000
6762813994,3580,9,3580,0,3,1990,725000
6762814120,1200,8,1030,170,3,1952,718500
6762814229,1640,7,1540,100,2,1916,710000
6762814230,2440,9,2440,0,3,2003,710000
6762814356,1660,9,1400,260,3,2002,700000
6762814610,3190,10,3190,0,4,1994,687500
6762814876,2400,7,1250,1150,3,1939,672500
6762814975,1110,7,1110,0,2,1925,665000
6762814976,2610,10,2610,0,3,1988,665000
6762815034,2500,7,1490,1010,5,1977,661500
6762815203,2540,9,2540,0,4,1987,652500
6762815452,2770,9,2770,0,4,1997,641000
6762816256,2420,8,1880,540,4,1981,602000
6762816610,2310,8,1730,580,3,2005,589500
6762817303,1960,7,980,980,3,1939,561500
6762817330,2710,9,2710,0,4,2003,560000
6762817591,4150,10,4150,0,4,2006,550000
6762818257,2860,8,1710,1150,4,1978,530000
6762818355,840,6,840,0,2,1937,528000
6762818555,1890,7,1090,800,5,1906,523460
6762818703,1100,9,1100,0,1,2014,516500
6762819028,1200,8,1200,0,2,2008,504200
6762819090,1520,7,1520,0,2,1951,500000
6762819091,1440,7,1440,0,4,1906,500000
6762819476,2230,8,2230,0,3,2000,490000
6762819717,2790,8,2790,0,4,2014,483453
6762819773,1500,7,1500,0,2,1902,480000
6762820183,2990,9,2990,0,4,1991,469900
6762820281,3060,9,3060,0,4,2012,465000
6762820357,2020,7,1380,640,4,1979,464900
6762820446,2110,8,1290,820,4,1985,460000
6762820528,2530,7,2530,0,4,2013,459000
6762820700,2300,8,1550,750,4,1979,453000
6762821011,1320,7,1320,0,2,1953,447000
6762821650,1050,7,850,200,2,1927,430000
6762821803,2432,9,2432,0,3,2005,427000
6762821854,1520,8,1520,0,3,1988,425000
6762822230,2300,7,1380,920,4,1959,417000
6762822288,2410,8,1860,550,3,1967,415000
6762822289,1060,8,1060,0,3,2000,415000
6762822290,2600,8,2600,0,3,2009,415000
6762822464,1400,8,1400,0,3,1981,410000
6762822465,2710,7,2710,0,3,1950,410000
6762822944,2570,9,2570,0,3,1989,399950
6762823060,1170,6,800,370,5,1944,397000
6762823182,3000,7,3000,0,4,2002,394000
6762824645,1890,8,1890,0,4,1996,355000
6762824646,1330,8,1330,0,2,1985,355000
6762824647,2040,8,2040,0,3,1980,355000
6762824856,2330,7,1180,1150,5,1968,350000
6762825276,1780,7,1280,500,3,1981,342000
6762825767,2440,8,1610,830,4,1978,330000
6762825955,2400,8,2400,0,5,1998,327000
6762826260,2570,8,2570,0,4,2005,320000
6762826478,3120,7,2090,1030,6,1993,315000
6762827084,1590,7,1590,0,3,1956,300000
6762827361,700,7,700,0,1,1907,295000
6762827663,1350,7,1350,0,4,2008,288790
6762827768,910,6,910,0,2,1948,285000
6762827936,690,6,690,0,1,1928,280000
6762828052,1630,8,1320,310,3,1985,279000
6762828155,720,6,720,0,2,1951,275500
6762828805,700,7,700,0,2,1922,260000
6762828902,1650,7,1650,0,3,1957,259500
6762828948,1715,7,1715,0,3,1995,257500
6762829014,1720,8,1720,0,3,1998,255000
6762829424,1670,7,1670,0,3,2014,246950
6762829807,1400,7,1400,0,3,1998,235000
6762829808,1950,7,1950,0,3,1960,235000
6762829809,1170,8,1070,100,1,2007,235000
6762829886,1390,7,1390,0,4,1955,234000
6762829957,1010,7,1010,0,3,1969,230000
6762830045,1110,8,1110,0,2,2014,229800
6762830253,910,7,910,0,3,1966,221000
6762830410,1220,6,1220,0,2,1972,215500
6762830496,940,7,940,0,2,1926,212700
6762830602,970,6,970,0,3,1967,209950
6762830913,1020,6,1020,0,2,1940,195000
6762830972,900,6,900,0,2,1905,191000
6762831245,810,6,810,0,2,1959,170000
6762831477,1060,7,1060,0,3,1959,140000
6762810451,2820,10,2460,360,3,1930,1600000
6762811271,3500,9,2140,1360,4,1951,1080000
6762814439,2190,8,1430,760,4,1972,699900
6762815243,1050,7,880,170,2,1904,650000
6762816442,3130,9,3130,0,4,1994,598000
6762816680,2670,7,1620,1050,5,1920,585000
6762819944,1700,8,1160,540,3,1998,475000
6762820122,1500,7,1140,360,3,1927,470000
6762825435,1200,7,1200,0,3,1969,339900
6762826583,1700,7,1200,500,3,1978,314500
6762827085,1370,7,1370,0,4,1949,300000
6762829887,1040,6,1040,0,3,1983,234000
6762829958,1910,8,1910,0,2,1980,230000
6762812620,2120,9,2120,0,3,1964,835000
6762818258,840,7,840,0,2,1924,530000
6762822755,2950,8,2120,830,4,1974,402000
6762823061,1360,8,1240,120,3,2007,397000
6762825147,1610,7,1610,0,3,1986,345000
6762826011,2130,7,1300,830,5,1991,325000
6762828617,1800,7,1800,0,3,1957,265000
6762810211,4350,10,4350,0,4,2013,2070000
6762810252,4830,11,3710,1120,5,1914,1930000
6762810354,5000,10,3410,1590,5,2008,1730000
6762810532,4390,10,4390,0,5,2007,1510000
6762810783,2680,9,1590,1090,4,1956,1310000
6762810947,2200,8,2200,0,3,1948,1230000
6762811004,2120,9,2120,0,4,1905,1200000
6762811076,3790,10,2810,980,3,1989,1170000
6762811213,3330,10,3330,0,4,1995,1100000
6762811647,2010,8,1610,400,4,1937,972000
6762811695,3530,10,3530,0,4,2007,963000
6762811753,3670,10,3670,0,4,2007,950000
6762811843,1780,9,1780,0,2,1974,935000
6762812117,2520,8,1570,950,5,1960,896000
6762812206,3560,8,3560,0,4,2014,882566
6762812210,3220,9,2320,900,4,1931,880000
6762812250,1800,8,1800,0,4,1929,875000
6762812464,2650,8,1830,820,3,1920,850000
6762813216,3500,9,3500,0,4,2005,780000
6762813418,2870,7,1950,920,5,1964,765000
6762813483,3300,8,3300,0,4,1984,760000
6762814934,2500,7,1520,980,4,1940,669500
6762815568,3350,8,2550,800,3,2005,635000
6762817059,1890,7,1470,420,3,1949,570000
6762817331,2070,8,2070,0,3,1955,560000
6762817592,1720,7,1220,500,3,1967,550000
6762817593,2750,7,1500,1250,4,1958,550000
6762817889,1460,8,1180,280,3,2007,544000
6762818124,1580,7,1180,400,3,1925,535000
6762818259,1980,8,1980,0,4,1981,530000
6762818729,2600,8,2600,0,3,2003,515000
6762819092,3720,7,3720,0,4,1979,500000
6762819431,2120,8,1640,480,4,1967,492650
6762819447,2090,7,1440,650,3,1958,491950
6762819449,1470,7,1470,0,3,1985,491500
6762819477,2330,9,1920,410,4,2003,490000
6762819774,2440,8,1890,550,4,1981,480000
6762820419,3600,6,2400,1200,3,1948,461000
6762820572,1220,8,1010,210,3,2008,457000
6762820973,2960,9,2960,0,4,2005,449000
6762821045,2070,8,1470,600,4,1977,445800
6762821192,1190,7,990,200,2,1919,441000
6762821338,3180,8,1810,1370,3,2006,439000
6762821421,2290,8,2290,0,4,1988,436500
6762821464,1880,7,970,910,4,1904,435000
6762821788,1090,8,1090,0,2,2008,427500
6762822177,1510,8,1510,0,2,2006,419000
6762822466,1010,7,1010,0,1,1911,410000
6762822565,2820,7,2320,500,5,1906,408000
6762822597,870,7,870,0,2,1947,406500
6762823044,2570,8,2570,0,4,1992,397500
6762823477,1300,7,1300,0,3,1968,385000
6762823558,2700,8,2700,0,4,2001,383962
6762824061,1320,7,1320,0,3,1982,370000
6762824528,2140,8,2140,0,4,1993,359500
6762824648,1370,8,1370,0,3,2005,355000
6762825036,960,7,960,0,3,1958,349810
6762825148,970,6,970,0,2,1932,345000
6762825149,2280,7,2280,0,4,2006,345000
6762825504,2230,7,2230,0,4,2002,337000
6762825768,2340,9,2340,0,4,1997,330000
6762825947,2310,8,2310,0,3,1990,327500
6762826815,1010,7,1010,0,3,1954,308000
6762827086,960,6,960,0,2,1947,300000
6762827619,1760,7,1760,0,3,1937,289950
6762827769,1830,7,1830,0,4,1991,285000
6762828618,1860,8,1260,600,2,1952,265000
6762828731,1360,6,960,400,4,1960,263400
6762828735,1410,7,1410,0,3,1985,263000
6762829015,1320,6,940,380,2,1919,255000
6762829211,1440,7,1440,0,3,1965,250000
6762829386,950,7,950,0,3,1954,248000
6762829465,1300,7,860,440,3,1996,245000
6762829571,1068,7,1068,0,2,1990,243000
6762829810,900,6,900,0,2,1928,235000
6762831246,1200,7,1200,0,2,1976,170000
6762831589,930,6,930,0,2,1942,100000
6762810033,7050,13,4320,2730,5,1978,3800000
6762810147,3530,9,1840,1690,3,1930,2370000
6762810156,3970,11,3390,580,4,1928,2300000
6762810369,3770,9,3070,700,4,1924,1700000
6762810427,3140,10,2240,900,3,1913,1640000
6762810488,2970,7,2130,840,4,1918,1570000
6762810706,4270,10,3170,1100,4,1937,1360000
6762810800,2630,9,2510,120,6,1900,1300000
6762811005,3400,10,2790,610,4,2008,1200000
6762811112,3340,10,3340,0,4,1996,1150000
6762811192,3350,8,2510,840,5,1997,1110000
6762811272,3890,8,3260,630,3,1967,1080000
6762811317,4570,11,4570,0,4,1990,1060000
6762811440,3770,10,3770,0,4,2008,1020000
6762811459,1640,6,1500,140,3,1920,1010000
6762811727,2130,8,2130,0,4,1914,955500
6762811735,2550,10,2550,0,4,1910,952500
6762811900,5190,11,5190,0,5,2001,925000
6762811942,4080,9,4080,0,4,2005,920000
6762812251,3840,9,3840,0,5,2001,875000
6762812465,4350,9,2200,2150,4,2006,850000
6762812715,3990,9,3990,0,4,2003,825000
6762812778,2880,10,2880,0,3,1989,820000
6762812906,2500,9,2500,0,4,1987,808000
6762812976,3830,10,3530,300,3,1993,800000
6762813809,3290,8,3290,0,5,2004,739900
6762813910,2130,7,1530,600,2,1941,730000
6762813947,2840,9,1780,1060,4,1977,729032
6762813995,1860,8,1860,0,3,1959,725000
6762814210,2375,9,2375,0,3,2002,712000
6762814492,2620,9,2620,0,3,1998,695000
6762814493,2500,7,1680,820,3,1922,695000
6762814532,2600,7,2600,0,4,1962,691500
6762815061,2570,9,1970,600,3,1983,660000
6762815244,3350,10,3350,0,4,2004,650000
6762815474,1540,9,1540,0,2,2007,640000
6762815706,2390,8,2220,170,3,2008,629800
6762815894,2130,7,1440,690,4,1948,620000
6762815979,1700,8,1700,0,4,1957,616000
6762816296,2510,10,2510,0,2,1990,600000
6762816297,2980,9,1580,1400,5,1960,600000
6762816298,910,6,910,0,2,1900,600000
6762816469,1820,8,1820,0,4,1987,595000
6762816553,1410,7,910,500,3,1947,590000
6762816771,1630,7,1630,0,4,1921,581000
6762816792,2200,9,2200,0,3,1978,580000
6762817060,2590,9,2590,0,4,1991,570000
6762817274,1410,7,1410,0,4,1911,563000
6762817780,2440,9,2440,0,4,1994,548000
6762817830,1530,7,1010,520,3,1928,545000
6762817952,2050,8,1400,650,3,1984,540000
6762817953,2180,7,1180,1000,4,1968,540000
6762818125,1420,7,1420,0,4,1945,535000
6762818260,3660,9,3260,400,3,1989,530000
6762818426,1160,8,1040,120,2,2012,525000
6762818730,2010,8,2010,0,3,1994,515000
6762818731,1050,7,1050,0,2,1907,515000
6762818856,1750,7,1750,0,3,1934,510000
6762818951,1990,8,1190,800,3,1977,507500
6762818989,2200,8,1100,1100,4,1962,505000
6762819051,1600,8,1600,0,3,1983,502000
6762819093,950,7,850,100,2,1926,500000
6762819094,3130,8,2180,950,5,1975,500000
6762819223,2910,8,2910,0,4,2013,499990
6762819632,2440,8,2090,350,3,1991,485000
6762819633,1430,7,1430,0,4,1900,485000
6762819736,1710,7,1710,0,3,1989,482000
6762819876,1640,8,1640,0,3,1994,478000
6762819909,2890,7,1590,1300,4,1945,476000
6762820447,1450,8,940,510,3,2008,460000
6762820522,1250,7,850,400,2,1929,459500
6762820728,1110,7,1110,0,3,1966,452000
6762820792,1400,8,1400,0,3,1963,450000
6762821065,2280,8,2280,0,4,1994,445000
6762821465,2530,9,2530,0,3,1993,435000
6762821568,1550,7,1180,370,4,1963,433000
6762821614,2300,7,2300,0,4,2001,431000
6762821855,1300,7,1300,0,3,1964,425000
6762821856,1950,7,1950,0,3,2009,425000
6762822219,2530,8,2530,0,4,2014,417838
6762822605,1580,7,1580,0,4,1928,406000
6762822736,800,6,800,0,2,1946,402500
6762822775,1240,7,1000,240,3,1984,401000
6762822978,2701,9,2701,0,4,2014,399895
6762823220,3740,8,2240,1500,5,1958,392000
6762823584,1040,7,1040,0,3,1967,382500
6762823844,2530,7,1800,730,3,1977,375000
6762824062,860,7,860,0,2,1952,370000
6762824584,2080,8,2080,0,3,2004,357500
6762825037,1270,7,1270,0,3,1963,349500
6762825150,1080,6,1080,0,2,1955,345000
6762825505,1460,8,1460,0,3,2006,337000
6762825706,1050,8,950,100,2,2007,332888
6762825769,1680,7,1080,600,3,1959,330000
6762825923,2550,7,1300,1250,4,1978,328950
6762826229,1830,7,1830,0,4,2003,321000
6762826584,2050,8,2050,0,3,1993,314500
6762826841,1150,7,1150,0,3,1927,307000
6762827087,1660,7,1660,0,3,2001,300000
6762827088,2090,8,1340,750,3,1987,300000
6762827089,2303,8,2303,0,4,2006,300000
6762827937,1090,7,1090,0,3,1962,280000
6762828143,370,5,370,0,1,1923,276000
6762828282,1970,7,1970,0,4,1987,274900
6762828806,770,6,770,0,2,1948,260000
6762828807,1920,7,1300,620,3,1961,260000
6762829466,1190,6,1190,0,3,1907,245000
6762829606,1770,7,1770,0,3,1986,241000
6762830320,1620,7,1620,0,3,1967,219950
6762830374,1400,7,1400,0,3,1984,217500
6762830688,1170,7,1170,0,3,1981,205000
6762830757,590,7,590,0,1,1926,202000
6762831223,900,6,900,0,2,1979,174000
6762831295,1200,7,1200,0,3,1959,165050
6762831586,820,5,820,0,2,1937,102500
6762810047,8020,11,8020,0,5,2001,3300000
6762810163,4080,11,4080,0,4,1983,2290000
6762810165,4040,9,4040,0,4,1954,2270000
6762810198,4660,10,3040,1620,3,1909,2150000
6762810631,3180,10,2610,570,2,1985,1410000
6762810801,2610,8,2610,0,4,1966,1300000
6762811273,3280,10,1680,1600,3,1970,1080000
6762811346,3390,9,2610,780,4,2014,1050000
6762811393,1440,8,1440,0,4,1967,1040000
6762811571,3830,9,3050,780,6,1919,989000
6762811974,3850,10,3120,730,3,2013,915000
6762812126,1950,8,1330,620,4,1947,895000
6762812378,1880,7,1880,0,4,1924,860000
6762812448,3760,9,2550,1210,5,1984,851000
6762812858,2470,8,1860,610,3,1977,811000
6762813070,2890,9,2890,0,4,2005,795000
6762813198,1570,7,1320,250,2,1906,782000
6762813841,1500,8,1100,400,2,1933,736000
6762813897,2670,8,2020,650,3,1977,732000
6762814050,2430,8,1630,800,4,1928,723000
6762814076,3550,10,2180,1370,4,1990,720000
6762814357,2490,9,2490,0,3,1993,700000
6762814549,1760,8,1760,0,3,1922,690000
6762814804,2900,8,1450,1450,5,1985,675000
6762815044,2950,7,1720,1230,5,1918,660500
6762815107,2090,7,2090,0,4,1951,659000
6762815396,2270,7,1370,900,3,1956,645000
6762815661,2190,8,1410,780,4,1979,630000
6762815762,1820,8,1540,280,3,2006,625000
6762816189,2080,8,1530,550,3,1973,605000
6762816190,2940,7,1520,1420,4,1961,605000
6762816299,2190,7,1110,1080,5,1965,600000
6762816389,2500,8,1810,690,4,2008,599950
6762816793,1900,8,1200,700,3,1905,580000
6762816933,2680,8,1590,1090,3,1974,575000
6762816934,1660,7,1660,0,4,1922,575000
6762817159,2280,8,1880,400,3,2006,567500
6762817547,1840,9,1840,0,3,1978,552000
6762817594,2160,7,1430,730,4,1987,550000
6762817831,1340,7,1340,0,3,1923,545000
6762817954,1320,7,1320,0,3,1994,540000
6762818126,2330,7,1390,940,3,1983,535000
6762818427,1530,7,830,700,2,1916,525000
6762818598,1490,10,1090,400,3,2008,520000
6762818658,2570,8,1470,1100,5,1950,519000
6762818828,1540,7,770,770,3,1920,512031
6762819331,900,7,900,0,2,1946,496000
6762819569,3700,9,3700,0,3,1982,489000
6762819702,1540,8,1540,0,4,2014,484998
6762819750,1550,8,1550,0,3,1987,481015
6762819775,1470,8,1470,0,3,1956,480000
6762819776,2160,7,2160,0,5,1998,480000
6762819945,2040,7,2040,0,4,1963,475000
6762819946,1850,7,1850,0,4,1981,475000
6762819947,2100,7,1050,1050,4,1962,475000
6762819948,2620,8,2620,0,4,2013,475000
6762820701,1660,7,1260,400,3,1983,453000
6762821466,1900,8,1900,0,3,1993,435000
6762822291,1520,7,1520,0,3,1956,415000
6762822440,2370,8,2370,0,4,1978,411000
6762823179,3002,8,3002,0,4,2004,394500
6762823376,2400,7,1500,900,4,1927,389000
6762824649,1730,7,1730,0,3,1954,355000
6762825151,2450,8,2450,0,5,2002,345000
6762825320,1954,8,1954,0,4,2005,340000
6762825422,2390,8,1840,550,3,1984,339950
6762825663,830,7,830,0,2,2005,334500
6762825770,2105,8,2105,0,4,2003,330000
6762825874,2120,7,2120,0,4,2002,329950
6762826692,700,6,700,0,2,1918,310000
6762826787,2242,8,2242,0,3,2014,309780
6762826899,2160,7,1360,800,2,1968,305000
6762826900,1580,7,1010,570,3,1962,305000
6762827090,1010,6,1010,0,2,1947,300000
6762828160,1520,7,1520,0,3,1992,275250
6762828288,1450,7,1450,0,3,2010,274500
6762828605,800,7,800,0,2,2008,265050
6762828619,1940,7,1940,0,4,1948,265000
6762828758,1870,7,1580,290,5,1962,262000
6762828808,1620,7,1620,0,4,1975,260000
6762828987,2050,7,2050,0,4,2002,256000
6762829016,2430,7,1430,1000,4,1960,255000
6762829017,1680,8,1680,0,4,2002,255000
6762829125,1310,7,940,370,2,1980,253000
6762829212,1920,8,1520,400,3,1965,250000
6762829213,1200,6,1200,0,3,1984,250000
6762830223,1110,7,1110,0,3,1991,223000
6762831058,1590,6,1090,500,5,1942,185000
6762831193,1780,7,1780,0,4,1991,175000
6762831543,1050,6,1050,0,2,1964,123000
6762810148,5010,11,4000,1010,4,2014,2350000
6762810278,3930,10,3930,0,4,2006,1880000
6762810334,2360,9,2360,0,3,1909,1760000
6762810431,2980,9,2150,830,4,1999,1630000
6762811006,3420,9,2540,880,5,1952,1200000
6762811113,3580,9,3580,0,5,2000,1150000
6762811145,2780,8,2110,670,3,1969,1140000
6762811162,3160,9,3160,0,4,1995,1130000
6762811214,5070,11,5070,0,4,2000,1100000
6762811394,4110,11,4110,0,4,1978,1040000
6762811420,4370,11,4370,0,4,2008,1030000
6762811441,3620,10,2730,890,3,2005,1020000
6762811460,2980,9,2980,0,4,1989,1010000
6762811626,2520,7,2520,0,6,1954,975000
6762811816,2490,9,2490,0,4,1968,940000
6762812466,3230,8,2430,800,3,1945,850000
6762812467,2470,9,2470,0,3,1961,850000
6762812621,4930,12,4930,0,4,2005,835000
6762812821,3150,9,3150,0,4,2002,815000
6762812865,1520,7,1520,0,3,1954,810000
6762814157,2080,8,2080,0,3,1997,715000
6762815245,1380,7,1380,0,3,1960,650000
6762815475,1980,8,1980,0,3,1959,640000
6762815627,2360,8,1980,380,4,1977,633000
6762816089,2300,8,1430,870,3,1955,610000
6762816135,1630,8,1630,0,3,2014,609000
6762816191,2800,8,1420,1380,4,1970,605000
6762816192,2610,8,2610,0,3,2001,605000
6762816300,3000,8,3000,0,5,1975,600000
6762816636,2190,7,1490,700,5,1940,588000
6762816935,1530,7,1410,120,3,1955,575000
6762817194,2230,8,1430,800,4,1969,565000
6762817499,2950,9,2950,0,3,2006,554950
6762817502,2020,9,1730,290,4,1943,554729
6762818329,1240,7,1240,0,3,1909,529950
6762818646,2590,8,2590,0,4,2014,519995
6762818732,2740,7,1390,1350,5,1977,515000
6762818932,1930,8,1930,0,2,1989,509000
6762819461,3316,9,3316,0,3,1986,490600
6762820053,1530,7,1530,0,3,1978,474000
6762821043,2250,8,2250,0,3,2000,445838
6762821315,1930,8,1300,630,3,2005,439990
6762821651,1810,7,1030,780,3,1958,430000
6762821857,1400,8,1400,0,3,2007,425000
6762822467,1700,7,1700,0,4,1972,410000
6762822615,1350,8,1120,230,2,2006,405500
6762822822,2230,7,1300,930,4,1963,400000
6762822974,1410,9,900,510,2,2011,399900
6762823112,1840,8,1360,480,5,1948,395000
6762823113,2640,8,2640,0,4,1963,395000
6762823258,1900,8,1900,0,4,2004,390000
6762824063,860,7,860,0,2,1956,370000
6762824595,870,7,870,0,2,1942,357000
6762825152,2040,7,2040,0,4,1999,345000
6762825277,2300,8,2300,0,4,2001,342000
6762825300,1390,6,1390,0,3,1908,341000
6762825321,2790,7,1470,1320,8,1977,340000
6762826620,1830,7,930,900,3,1950,312500
6762826981,2600,7,1610,990,4,1969,304900
6762827339,1190,7,1190,0,2,1948,295950
6762827536,1440,7,1440,0,3,1967,290000
6762827672,1520,7,1520,0,3,2004,288000
6762827770,2270,8,2270,0,5,1995,285000
6762827906,1890,8,1890,0,4,1997,280500
6762828571,1740,7,1020,720,3,1962,267000
6762828601,1180,7,1180,0,3,1992,265900
6762828620,1020,7,1020,0,3,1959,265000
6762828710,2060,7,1200,860,4,1962,264500
6762829018,920,7,920,0,2,1995,255000
6762829214,1770,7,1770,0,3,1959,250000
6762829629,1570,7,1570,0,3,1960,240000
6762830272,1200,6,1200,0,4,1923,220000
6762830881,2080,7,1050,1030,4,1966,198000
6762831590,660,4,660,0,2,1912,100000
6762815763,1300,7,1300,0,3,1960,625000
6762816301,2320,8,2320,0,3,2003,600000
6762810349,2920,9,2260,660,4,1937,1740000
6762811007,2700,9,2700,0,4,2004,1200000
6762812716,2110,8,2110,0,4,1972,825000
6762814892,3130,7,1750,1380,4,1953,671000
6762819270,1540,8,1390,150,3,1995,499000
6762820523,1470,7,1030,440,3,1984,459500
6762810846,3160,9,2020,1140,4,1917,1280000
6762815764,1990,7,1090,900,2,1952,625000
6762823114,1480,8,1480,0,3,1975,395000
6762810428,3110,9,2550,560,3,1946,1640000
6762810586,3770,9,2710,1060,4,1925,1450000
6762810707,5430,10,5430,0,4,1987,1360000
6762810802,2360,9,2360,0,4,2013,1300000
6762810847,3870,9,3870,0,3,1997,1280000
6762812174,3540,10,3540,0,3,1989,888550
6762812252,1820,7,1820,0,3,1952,875000
6762812299,3040,9,2680,360,4,1923,870000
6762812329,3990,9,3990,0,4,2004,866000
6762812367,3595,9,3595,0,5,2014,861990
6762812771,2760,8,1690,1070,3,1967,821000
6762813217,2600,8,1400,1200,4,1953,780000
6762813288,4100,9,2500,1600,4,1981,775000
6762813716,2350,9,2350,0,4,1977,747500
6762814634,2030,8,2030,0,3,1980,685000
6762814690,1880,8,1880,0,3,1984,681000
6762814700,2330,9,2330,0,4,2005,680000
6762814900,4050,8,2620,1430,6,1970,670000
6762814901,2860,8,2860,0,5,1958,670000
6762814977,2800,8,1400,1400,5,1963,665000
6762815397,2690,8,2690,0,4,1985,645000
6762815645,2530,8,1910,620,4,1910,631500
6762816524,1830,10,1690,140,3,2011,593000
6762816637,1860,7,1860,0,3,1908,588000
6762816936,2400,8,2400,0,4,1990,575000
6762817061,1890,7,1390,500,3,1901,570000
6762817062,1640,7,820,820,3,1924,570000
6762817413,1580,6,790,790,2,1910,558000
6762817458,1740,7,1640,100,3,1920,555000
6762817775,1660,7,1260,400,4,1930,548800
6762817909,2040,8,2040,0,3,1987,542500
6762818054,2590,8,2590,0,3,1984,538250
6762818092,1130,8,1030,100,2,2009,536000
6762818261,1320,7,870,450,3,1918,530000
6762818379,3000,8,1500,1500,6,1979,527000
6762818857,1420,8,1420,0,3,2014,510000
6762818925,3030,8,3030,0,3,2009,509900
6762818990,1060,8,940,120,2,2006,505000
6762819095,1700,7,850,850,4,1955,500000
6762819096,1720,9,1720,0,3,2011,500000
6762819415,1910,8,1910,0,3,2014,494815
6762819421,1290,7,1290,0,2,1906,494000
6762819751,2286,8,2286,0,4,2002,481000
6762819777,1680,7,1130,550,3,1959,480000
6762819949,2510,7,1490,1020,5,1977,475000
6762820793,1990,8,1990,0,3,1993,450000
6762820794,1480,8,1480,0,3,1971,450000
6762821066,1240,7,1240,0,2,1985,445000
6762821142,1650,8,1650,0,5,1902,443000
6762821392,1490,6,1490,0,3,1948,437500
6762821409,2220,8,2220,0,3,1967,437000
6762822068,1620,8,1540,80,3,2009,420000
6762822468,1450,7,1450,0,3,1989,410000
6762822699,2340,8,2340,0,4,1982,404950
6762823233,1920,8,1920,0,3,1993,391500
6762823585,1190,6,1190,0,2,1981,382500
6762823779,1601,7,1536,65,3,2007,378000
6762823983,1260,7,1260,0,2,2001,374000
6762823996,1590,7,1590,0,4,1960,373000
6762824416,1800,8,1800,0,3,1931,360000
6762824817,2370,8,2370,0,3,2014,351999
6762825452,1450,7,1450,0,3,2004,339000
6762825540,800,7,800,0,2,1951,335950
6762825930,2250,8,2250,0,3,1998,328000
6762826261,1560,6,910,650,3,1948,320000
6762826262,2220,7,1270,950,3,1950,320000
6762826263,1120,7,1120,0,3,1969,320000
6762827091,2200,6,2200,0,4,1960,300000
6762827092,930,6,930,0,3,1919,300000
6762827093,2090,7,2090,0,4,2007,300000
6762827331,1520,7,1520,0,3,2004,296475
6762827362,1940,8,1940,0,3,1918,295000
6762827363,1640,7,1640,0,3,1908,295000
6762828592,1995,8,1995,0,4,1981,266000
6762829467,1500,7,1190,310,2,1926,245000
6762829959,1390,5,1390,0,3,1954,230000
6762829960,1140,8,1140,0,3,2014,230000
6762830047,1230,7,1230,0,3,1967,229500
6762830422,960,7,960,0,3,1967,215000
6762830603,1180,7,1180,0,3,1968,209950
6762830835,1100,6,1100,0,3,1961,199990
6762830914,1190,5,1190,0,2,1910,195000
6762831241,1060,7,820,240,2,1981,170500
6762810127,6500,11,5180,1320,4,2001,2460000
6762810194,4710,10,3690,1020,6,1931,2180000
6762810393,3490,9,2150,1340,3,1939,1680000
6762810489,2890,10,2890,0,4,1984,1570000
6762810980,3150,9,3150,0,4,2014,1210000
6762811008,3960,10,2850,1110,4,2006,1200000
6762811114,3830,11,3830,0,3,1991,1150000
6762811146,7320,11,7320,0,5,1992,1140000
6762811163,2790,8,2790,0,3,2006,1130000
6762811181,3180,10,2390,790,4,1978,1120000
6762811251,2360,9,2360,0,2,1997,1090000
6762811347,4740,10,4740,0,4,1991,1050000
6762811348,2250,8,1500,750,4,1927,1050000
6762811515,3130,10,3130,0,4,2013,999000
6762811655,3500,9,2950,550,5,1927,970000
6762811754,3480,7,1750,1730,3,1941,950000
6762812062,3180,11,3180,0,3,1978,900000
6762812153,2310,8,2310,0,4,1979,890000
6762812253,3110,8,3110,0,4,1979,875000
6762812799,3176,9,2726,450,3,1985,819000
6762812852,3370,9,2750,620,4,2007,812000
6762812866,2700,9,2700,0,2,2007,810000
6762813138,3420,10,1750,1670,3,1987,789900
6762813199,5270,10,3440,1830,4,2004,782000
6762813218,2560,8,1690,870,2,1901,780000
6762813419,3010,10,3010,0,4,2004,765000
6762813475,3090,9,3090,0,4,2010,760005
6762814077,2410,8,2410,0,4,1965,720000
6762814217,3580,10,2370,1210,4,1991,711600
6762814483,2510,8,1600,910,5,1975,695500
6762814550,3220,9,3220,0,4,1991,690000
6762814862,2610,8,2610,0,4,2006,674600
6762814869,2830,8,2830,0,3,2012,673000
6762815246,3720,9,1880,1840,4,2003,650000
6762815398,2850,9,2850,0,4,1987,645000
6762815662,2290,9,2290,0,2,2005,630000
6762815854,2050,8,2050,0,3,1973,623000
6762816054,1170,8,1170,0,2,1927,613000
6762816302,1900,7,1440,460,3,1969,600000
6762816303,2250,8,2250,0,4,1991,600000
6762816412,2560,8,1330,1230,3,1987,599000
6762816536,1570,8,1570,0,2,2006,592350
6762816681,2630,9,2630,0,4,1999,585000
6762816794,2130,8,1490,640,4,1980,580000
6762816795,1940,7,1520,420,3,1987,580000
6762817150,2790,7,1450,1340,4,1956,568000
6762817332,1950,8,1330,620,4,1968,560000
6762817423,1820,8,1820,0,3,1984,557500
6762817595,2490,8,1720,770,3,2005,550000
6762817916,1070,7,1070,0,3,1966,542000
6762818262,1785,7,1595,190,2,1975,530000
6762818369,2820,8,1550,1270,5,1968,527700
6762818697,1920,7,960,960,2,1912,517000
6762818812,1810,8,1810,0,3,1992,513000
6762819634,1900,8,1370,530,4,1977,485000
6762819778,1060,7,860,200,2,1924,480000
6762819860,1340,7,1340,0,3,1955,479000
6762820175,2530,8,2530,0,4,1997,469950
6762820210,1830,7,1830,0,3,1962,468000
6762820448,2620,9,2620,0,4,1991,460000
6762820552,1910,8,1910,0,4,1921,458400
6762820621,3440,8,3440,0,4,2002,455000
6762820940,2680,8,2680,0,4,2013,449990
6762821232,1860,8,1860,0,3,1998,440000
6762821339,2570,8,2570,0,4,1980,439000
6762821374,1270,8,1270,0,2,2000,438000
6762821467,2230,8,1320,910,4,1998,435000
6762821468,2150,7,2150,0,4,2010,435000
6762821652,1550,7,830,720,3,1942,430000
6762821786,880,7,880,0,2,1940,427550
6762822292,1920,7,1920,0,4,1970,415000
6762822416,1880,7,940,940,3,1945,412000
6762822469,2060,8,1220,840,4,1963,410000
6762822470,2560,9,2560,0,4,2006,410000
6762822471,1320,7,1320,0,3,1920,410000
6762822643,1010,7,1010,0,3,1953,405000
6762822983,1360,7,1360,0,4,1928,399500
6762823259,1180,7,1180,0,3,1967,390000
6762823566,2090,7,2090,0,3,1961,383000
6762823638,1984,8,1564,420,4,1962,380000
6762823773,2860,9,2860,0,3,1990,378500
6762823845,1660,7,1130,530,3,1976,375000
6762824031,1650,7,980,670,3,1954,371500
6762824064,1570,7,1570,0,3,1982,370000
6762824184,2100,7,1030,1070,4,1964,368000
6762824374,1810,7,1810,0,5,1998,362000
6762824583,1210,8,1210,0,2,2014,357562
6762824650,3000,8,3000,0,4,2005,355000
6762825322,2120,8,2120,0,3,1997,340000
6762825528,2760,8,2760,0,3,1969,336000
6762825529,2530,8,2530,0,4,1993,336000
6762825545,2538,8,2538,0,3,2013,335606
6762825687,2250,8,2250,0,4,2014,333490
6762825722,2120,9,1720,400,3,1979,332000
6762825771,2220,7,1330,890,3,1993,330000
6762825971,1060,7,1060,0,3,1968,326500
6762826012,800,7,800,0,2,1953,325000
6762826013,810,6,810,0,2,1941,325000
6762826264,1450,8,1180,270,3,2013,320000
6762826479,1080,6,720,360,2,1919,315000
6762826806,1920,7,1920,0,4,1994,308950
6762827094,2200,7,2200,0,4,1998,300000
6762827095,1150,7,1150,0,3,1960,300000
6762827458,1910,8,1910,0,3,2009,293000
6762827469,1520,7,1520,0,3,1959,292600
6762828124,770,6,770,0,2,1948,277000
6762828572,1400,6,1400,0,3,1944,267000
6762829019,1550,7,1050,500,3,1976,255000
6762829215,1140,7,1140,0,3,1983,250000
6762829353,1090,7,1090,0,2,1982,249000
6762829468,2600,8,1390,1210,4,1978,245000
6762829469,1600,7,1600,0,3,1992,245000
6762829786,2340,8,1670,670,5,1967,235500
6762829811,1020,6,1020,0,2,1939,235000
6762829918,1460,7,1460,0,3,1966,232000
6762830069,1200,7,1200,0,3,1968,228950
6762830548,960,6,960,0,3,1949,210000
6762830549,1070,6,1070,0,3,1949,210000
6762830689,1180,7,1180,0,3,1967,205000
6762830766,1320,7,1320,0,3,1912,201500
6762830984,910,7,910,0,3,1968,190000
6762831094,1040,6,800,240,3,1958,183500
6762831299,850,6,850,0,1,1906,165000
6762831342,1350,6,1350,0,3,1942,160000
6762831452,1400,7,1400,0,3,1968,148226
6762831454,630,6,630,0,2,1930,148000
6762831557,1150,7,1150,0,1,1962,115000
6762810098,4290,11,4290,0,5,1985,2680000
6762810153,5780,11,4260,1520,5,2006,2320000
6762810394,4830,9,3930,900,5,1952,1680000
6762810577,4230,8,2360,1870,6,1916,1470000
6762810708,3550,11,2260,1290,4,1999,1360000
6762810894,2920,10,2030,890,4,1957,1250000
6762810927,5430,10,4010,1420,5,2007,1240000
6762811300,4260,10,4260,0,4,2008,1070000
6762811395,4440,11,4440,0,4,2003,1040000
6762811572,4030,11,4030,0,5,2000,989000
6762812063,2230,8,1540,690,4,1935,900000
6762812571,2783,8,2783,0,3,1910,840000
6762812867,2000,7,1000,1000,4,1958,810000
6762813484,3300,9,3300,0,4,2014,760000
6762813533,2100,7,1340,760,4,1975,759000
6762813613,3020,9,3020,0,4,2004,750000
6762813692,2910,9,2210,700,4,1957,749950
6762813706,2820,9,2820,0,3,2008,749000
6762813707,2700,8,2100,600,4,1910,749000
6762813763,2150,8,2150,0,2,2010,741500
6762813775,3360,9,3360,0,4,1997,740000
6762813834,2320,7,2320,0,3,1935,737500
6762813836,2290,8,2290,0,2,2007,737000
6762813875,4280,10,3050,1230,4,2002,734950
6762814067,3350,9,3350,0,4,1985,720500
6762814358,1410,6,1410,0,3,1901,700000
6762814480,3650,9,2550,1100,4,1996,696000
6762814525,3710,9,3710,0,4,1999,692500
6762814701,1780,7,980,800,3,1925,680000
6762814751,2100,7,1780,320,4,1928,679000
6762815062,1240,7,1240,0,3,1927,660000
6762815063,2510,8,2510,0,4,2002,660000
6762815098,3510,9,3510,0,4,2014,659950
6762815569,3080,9,3080,0,4,1997,635000
6762815663,1710,8,1710,0,3,1986,630000
6762815765,1600,7,1600,0,4,1946,625000
6762815766,3160,8,2160,1000,3,1978,625000
6762815843,2250,8,1500,750,3,1964,624800
6762816090,2630,8,2630,0,3,2001,610000
6762816390,1830,8,1830,0,3,2014,599950
6762816413,2580,7,1880,700,7,1901,599000
6762816470,3730,9,2760,970,4,2015,595000
6762816506,2720,9,2720,0,4,1989,594950
6762816554,2650,8,1680,970,3,1975,590000
6762816751,2600,8,2600,0,3,1998,583000
6762816796,1850,7,1020,830,3,1909,580000
6762817063,4000,10,3080,920,6,2004,570000
6762817136,2220,8,1770,450,3,1929,569000
6762817195,2500,9,2500,0,3,1990,565000
6762817307,2570,8,2570,0,4,1990,561000
6762817333,1960,8,1960,0,3,2002,560000
6762817334,1010,7,1010,0,2,1960,560000
6762817596,1970,8,1270,700,3,1929,550000
6762817597,2150,7,1110,1040,4,1966,550000
6762817598,1440,7,1440,0,4,1924,550000
6762817832,2760,9,2760,0,3,2002,545000
6762818059,3010,8,3010,0,3,2009,538000
6762818263,1790,8,1790,0,3,2010,530000
6762818428,2910,8,1640,1270,4,1985,525000
6762818429,1710,7,1710,0,4,1955,525000
6762818430,3670,10,3670,0,4,2005,525000
6762818958,2140,8,1490,650,3,1950,507000
6762819295,1350,8,1350,0,2,2008,498800
6762819356,2660,9,2660,0,3,1964,495000
6762819602,2540,9,2540,0,4,2005,487000
6762819614,3560,10,3560,0,4,1988,486000
6762819779,2550,8,1390,1160,5,1967,480000
6762820123,2380,8,1530,850,4,1979,470000
6762820211,2100,7,1240,860,4,1976,468000
6762820385,1980,7,1980,0,4,1974,463000
6762820795,2850,7,1930,920,5,1925,450000
6762820796,1460,8,1460,0,3,1983,450000
6762821143,1920,7,1920,0,3,1989,443000
6762821233,1270,8,1270,0,3,2007,440000
6762821469,2550,7,2550,0,4,2009,435000
6762821858,1320,7,1020,300,2,1939,425000
6762822069,1510,7,1510,0,3,1954,420000
6762822293,1840,7,1840,0,4,1950,415000
6762822417,3360,9,2450,910,4,1990,412000
6762822472,1660,7,830,830,3,1980,410000
6762822550,3320,8,2480,840,5,1999,409124
6762822823,1760,8,1760,0,3,1967,400000
6762822945,1970,7,1320,650,5,1986,399950
6762823115,930,7,930,0,2,1940,395000
6762823116,1970,8,1970,0,4,1961,395000
6762823639,780,6,780,0,2,1918,380000
6762823753,1530,7,1530,0,3,1986,379000
6762823962,1390,8,1390,0,3,2007,374950
6762824535,1550,7,1080,470,3,1978,359000
6762824617,1590,7,1590,0,3,2000,356000
6762825323,1600,7,1600,0,3,1958,340000
6762825546,1370,6,1370,0,3,1930,335500
6762826224,730,7,730,0,1,2008,321500
6762826693,1460,7,1460,0,3,1952,310000
6762826796,1980,7,1300,680,3,1963,309000
6762826865,1450,7,1010,440,3,1969,306000
6762826901,1800,7,1800,0,3,1966,305000
6762827096,1820,6,1190,630,4,1926,300000
6762827232,1460,7,1460,0,3,2000,299880
6762827364,800,6,800,0,2,1953,295000
6762827537,1950,8,1950,0,3,1959,290000
6762827697,1730,7,1010,720,5,1962,287000
6762827839,1880,7,1130,750,4,1960,284000
6762827840,1500,7,1500,0,3,1957,284000
6762828179,2030,7,2030,0,4,1944,275000
6762828180,1200,7,1200,0,3,1954,275000
6762828395,1660,7,1660,0,4,1978,270000
6762829149,1120,7,1120,0,4,1966,252000
6762829216,990,7,990,0,3,1960,250000
6762829470,1610,7,1610,0,3,1994,245000
6762829752,1460,7,1460,0,2,1987,237950
6762829915,1940,7,1140,800,3,1969,232500
6762830055,2010,8,1170,840,4,1979,229000
6762830102,990,6,990,0,3,1943,226550
6762830423,1860,8,1860,0,4,1920,215000
6762830424,1770,8,1770,0,3,1959,215000
6762830425,1200,7,1200,0,3,1967,215000
6762831041,840,6,840,0,2,1952,187000
6762831397,1600,6,1600,0,4,1966,154950
6762831429,490,5,490,0,3,1959,150000
6762831492,960,6,960,0,3,1970,137124
6762810231,4800,10,3580,1220,6,2007,1980000
6762810258,4460,10,3140,1320,4,1955,1910000
6762810441,5470,11,3730,1740,4,1992,1610000
6762810505,6070,12,6070,0,5,1999,1550000
6762810753,5720,10,4170,1550,6,2004,1330000
6762810895,3460,10,2850,610,3,2007,1250000
6762811721,1800,8,1800,0,4,1984,958000
6762812211,2640,8,1760,880,6,1922,880000
6762812233,3360,10,3360,0,4,1994,879000
6762812254,2960,9,2960,0,5,2004,875000
6762812379,3480,8,3480,0,5,1979,860000
6762812468,2310,8,2310,0,5,1966,850000
6762812529,4230,10,3860,370,5,1996,847700
6762812572,3840,11,3840,0,4,1998,840000
6762812977,2220,8,1700,520,3,1914,800000
6762813059,1370,9,1370,0,3,1907,797000
6762813289,2980,7,2480,500,6,1916,775000
6762813369,3000,9,1610,1390,5,2007,770000
6762813708,2130,8,2130,0,4,1920,749000
6762813776,1830,7,1350,480,3,1910,740000
6762813853,2820,9,2820,0,3,2004,735000
6762813996,1950,7,1010,940,2,1919,725000
6762813997,1690,7,1690,0,3,1959,725000
6762814078,3340,10,3340,0,4,1999,720000
6762814196,1810,8,1810,0,3,1959,713400
6762814231,2870,8,1870,1000,4,1968,710000
6762814494,3310,9,2400,910,4,1992,695000
6762814805,1920,7,960,960,3,1924,675000
6762814806,2390,9,2390,0,4,2006,675000
6762814902,1420,9,1280,140,3,2003,670000
6762815126,2320,7,1510,810,3,1956,657500
6762815135,2640,8,2640,0,4,1995,657000
6762815152,2170,7,1920,250,4,1980,655000
6762815521,1840,7,920,920,4,1942,639000
6762816091,2600,8,1580,1020,4,1976,610000
6762816304,2410,7,1940,470,2,1912,600000
6762816538,3340,8,2580,760,5,2012,592000
6762817122,1140,7,1140,0,4,1916,569950
6762817510,1670,8,1670,0,2,2004,554000
6762817833,2930,8,1680,1250,2,1980,545000
6762817834,2060,8,2060,0,3,1987,545000
6762817935,2800,8,2320,480,3,1996,540500
6762818127,2850,8,2370,480,5,2006,535000
6762818431,2280,7,1250,1030,4,1947,525000
6762818432,1340,7,1340,0,2,1903,525000
6762818991,1240,7,1240,0,2,1962,505000
6762819097,1640,7,1640,0,3,1989,500000
6762819236,1520,7,1520,0,4,1967,499950
6762819950,1880,8,1180,700,3,1951,475000
6762820193,2690,8,1790,900,5,1960,469000
6762821067,840,7,840,0,2,1926,445000
6762821340,1560,7,1560,0,4,1968,439000
6762821817,2700,9,2700,0,4,1998,426500
6762822208,1500,8,1500,0,2,2005,418000
6762822247,2320,8,1160,1160,4,1956,416100
6762822473,1470,7,1470,0,3,1953,410000
6762822824,2680,7,2350,330,4,1943,400000
6762823729,3110,9,3020,90,3,1999,379900
6762823754,1280,7,1080,200,4,1920,379000
6762824417,2380,8,2380,0,4,2005,360000
6762824651,2110,8,2110,0,3,1989,355000
6762824857,1170,6,1170,0,4,1959,350000
6762824858,2800,8,2800,0,4,1993,350000
6762824859,1720,7,860,860,4,1971,350000
6762825066,1500,7,1500,0,3,2005,348000
6762825153,3140,8,1670,1470,3,1985,345000
6762825266,1320,8,1100,220,2,2008,342500
6762825524,1420,7,1420,0,3,1981,336500
6762826480,2340,7,2340,0,3,1992,315000
6762826836,1480,7,1480,0,3,1959,307150
6762826842,1714,8,1714,0,4,2009,307000
6762827003,970,6,970,0,2,1940,303000
6762827365,740,5,740,0,2,1915,295000
6762827526,1720,8,1720,0,3,1983,290256
6762828053,670,6,670,0,2,1942,279000
6762828108,1889,7,1889,0,4,2012,277950
6762828181,1830,7,1830,0,4,2007,275000
6762828302,1550,7,1550,0,3,2009,273500
6762828621,1530,7,1530,0,3,1991,265000
6762828736,1580,8,1180,400,3,1993,263000
6762828809,1490,7,1490,0,3,1990,260000
6762829217,1440,7,1440,0,3,1986,250000
6762829218,1010,6,1010,0,3,1944,250000
6762829589,960,6,960,0,2,1947,242000
6762829929,1630,7,1130,500,3,1973,231500
6762830792,2090,7,1070,1020,4,1974,200000
6762830915,860,6,860,0,2,1983,195000
6762831413,920,7,920,0,3,1978,152000
6762831430,1200,7,1200,0,3,1959,150000
6762831564,740,6,740,0,2,1942,114975
6762810077,4575,10,3905,670,4,1926,2920000
6762810410,4040,9,2020,2020,8,1962,1650000
6762810538,4410,12,3420,990,4,1996,1500000
6762810564,3700,11,2280,1420,3,1998,1480000
6762811301,4860,11,3860,1000,6,1998,1070000
6762811627,4300,10,4300,0,5,2004,975000
6762812395,3520,9,3520,0,4,2014,859990
6762812842,3190,9,3190,0,3,2014,814842
6762812903,2900,9,2900,0,5,2006,808900
6762812978,3220,8,3220,0,4,1968,800000
6762813110,3560,10,3560,0,4,2006,790000
6762813111,3500,9,3500,0,4,2004,790000
6762813219,3190,10,3190,0,3,1998,780000
6762813731,2050,9,2050,0,3,1959,745000
6762814978,3320,9,3320,0,5,2000,665000
6762815450,1060,7,1060,0,3,1952,641200
6762815476,3040,9,2320,720,4,1986,640000
6762815570,3420,9,3030,390,4,2012,635000
6762815767,1230,7,910,320,3,1927,625000
6762815768,2530,8,1470,1060,4,1976,625000
6762815895,2210,8,1710,500,4,1967,620000
6762816267,2090,8,2090,0,4,1992,601000
6762816764,2780,8,1590,1190,5,1968,582000
6762816797,2310,6,2310,0,7,1915,580000
6762816882,1790,8,1790,0,3,1984,578000
6762816937,2440,9,1620,820,4,1960,575000
6762817064,1790,8,1790,0,4,1972,570000
6762817196,2140,7,1070,1070,4,1948,565000
6762818186,2240,8,1280,960,5,1956,534950
6762818264,2130,7,1430,700,4,1969,530000
6762818433,1560,7,1220,340,3,1969,525000
6762819026,2360,7,1390,970,5,2008,504600
6762819098,1320,7,1320,0,3,1951,500000
6762819560,2090,8,2090,0,4,2006,489900
6762819720,2440,9,2440,0,3,1992,483000
6762819951,2200,7,1290,910,4,1980,475000
6762819952,1380,8,1380,0,3,2008,475000
6762820232,1140,8,1140,0,2,2007,467000
6762820352,2230,7,1230,1000,4,1978,464950
6762820449,1610,9,1080,530,3,2005,460000
6762820797,1810,8,1380,430,3,2008,450000
6762821234,1450,8,1450,0,3,1983,440000
6762821235,1900,8,1220,680,3,1970,440000
6762821724,1760,7,1090,670,4,1947,429950
6762822418,1430,7,1130,300,4,1960,412000
6762822644,1600,7,1600,0,3,1966,405000
6762822825,2020,6,1010,1010,3,1910,400000
6762823045,1470,8,930,540,3,2006,397500
6762823358,2240,8,2240,0,4,2013,389950
6762823478,1860,8,930,930,3,1922,385000
6762823640,1470,6,1470,0,2,1949,380000
6762824065,1170,7,1170,0,3,1965,370000
6762824139,1640,8,1200,440,3,1965,369950
6762824860,2650,8,2650,0,4,1989,350000
6762825231,2490,8,2490,0,4,2000,344200
6762825436,2340,8,1610,730,4,1981,339900
6762825453,2090,7,1290,800,3,1979,339000
6762825875,1920,7,1920,0,4,2002,329950
6762825978,1930,7,1930,0,3,2004,326000
6762826374,1640,7,1640,0,3,1966,319000
6762826375,1480,7,1480,0,3,2007,319000
6762826481,1660,7,1660,0,3,1991,315000
6762826588,1810,7,1210,600,3,1980,314000
6762827004,2560,7,1790,770,4,1976,303000
6762827203,1600,8,1600,0,3,1993,299950
6762827254,1650,8,1650,0,3,2011,299000
6762827538,840,6,840,0,2,1919,290000
6762827633,1220,7,1220,0,3,1966,289900
6762828396,1690,7,1690,0,3,1992,270000
6762828933,1680,6,880,800,3,1948,258000
6762829219,1030,6,1030,0,2,1956,250000
6762829220,920,7,920,0,3,1952,250000
6762829437,1440,8,1440,0,3,1966,246000
6762829812,2350,8,1570,780,3,1966,235000
6762829961,1330,7,1330,0,3,1967,230000
6762830669,1140,7,1140,0,3,1968,206000
6762830690,1820,7,1820,0,3,1962,205000
6762830836,890,6,890,0,2,1935,199990
6762830942,810,6,810,0,2,1923,194900
6762831300,640,6,640,0,2,1942,165000
6762831325,950,8,950,0,2,1972,162950
6762831343,1480,7,1000,480,3,1980,160000
6762812595,3010,9,3010,0,4,2014,839950
6762814551,2900,9,2900,0,4,1992,690000
6762819440,1290,6,890,400,2,1922,492000
6762820754,900,7,900,0,2,1944,451000
6762824162,1320,8,1270,50,3,2004,369000
6762825566,1530,7,1530,0,3,2011,335000
6762825567,950,7,950,0,3,1968,335000
6762826265,2220,7,1270,950,4,1961,320000
6762829813,1420,7,1420,0,3,1962,235000
6762816863,2030,8,2030,0,4,1983,579000
6762827097,1870,7,1870,0,3,2005,300000
6762827771,1720,7,1720,0,3,1962,285000
6762810339,4650,11,3640,1010,4,2008,1750000
6762810355,3470,9,2360,1110,4,1906,1730000
6762810525,5930,11,3920,2010,5,1996,1520000
6762810526,3650,9,2330,1320,4,1907,1520000
6762810701,2700,9,2700,0,2,1990,1370000
6762810878,3730,10,3730,0,4,1990,1260000
6762810969,4560,10,4040,520,3,2001,1220000
6762811009,3430,10,3430,0,3,1984,1200000
6762811193,3070,9,2050,1020,5,2006,1110000
6762811215,2210,9,1550,660,4,1977,1100000
6762811318,5320,11,5320,0,4,2003,1060000
6762811421,3600,10,3000,600,4,2013,1030000
6762811599,2750,8,1750,1000,5,1904,980000
6762811600,2190,8,2190,0,4,1910,980000
6762811755,3330,9,3330,0,3,1988,950000
6762811756,3820,10,3820,0,4,2003,950000
6762811859,3940,9,3110,830,3,1992,933399
6762811881,3790,11,3790,0,3,1993,929950
6762812154,4030,9,2800,1230,3,1975,890000
6762812469,2720,8,2720,0,4,1975,850000
6762812470,2220,8,1620,600,3,1919,850000
6762812868,1760,8,1760,0,4,1906,810000
6762813024,3040,9,1760,1280,6,1958,799950
6762813290,2880,8,2050,830,4,1955,775000
6762813732,3010,8,1890,1120,3,1970,745000
6762813972,2970,9,2970,0,5,2000,726000
6762814121,2840,9,2840,0,4,2008,718500
6762814144,1640,7,1640,0,3,1909,716100
6762814219,2550,9,2550,0,3,2004,711000
6762814807,2140,7,1000,1140,2,1930,675000
6762814808,2900,8,2900,0,4,2002,675000
6762814903,1650,7,1000,650,2,1959,670000
6762815247,2010,7,1300,710,4,1963,650000
6762815248,2540,8,1880,660,3,1937,650000
6762815249,2530,8,1720,810,4,1975,650000
6762815250,920,6,920,0,1,1996,650000
6762815251,1910,9,1910,0,3,2006,650000
6762815664,2510,8,1610,900,4,1977,630000
6762815709,2660,9,2660,0,4,1996,629000
6762815998,1950,8,1250,700,3,1962,615000
6762816092,1630,8,1630,0,3,2014,610000
6762816142,3030,8,3030,0,4,1986,608250
6762816193,1270,8,1270,0,2,1921,605000
6762816257,1640,8,1640,0,3,1998,602000
6762816305,1770,7,1240,530,4,1946,600000
6762816414,2950,8,2950,0,5,2006,599000
6762816682,3140,7,2320,820,4,1951,585000
6762816798,2040,7,1020,1020,3,1925,580000
6762816799,3200,9,2660,540,3,1967,580000
6762816909,1140,7,1010,130,3,1909,576000
6762816938,2810,8,1490,1320,4,1954,575000
6762816939,2990,9,1800,1190,5,1972,575000
6762816940,2070,9,1500,570,4,2013,575000
6762817065,2640,8,2640,0,4,1998,570000
6762817335,1980,8,1210,770,4,1931,560000
6762817391,2120,7,2120,0,3,2001,559950
6762817459,1570,7,1570,0,3,1968,555000
6762817599,1680,7,1400,280,3,1960,550000
6762817600,1410,7,810,600,3,1923,550000
6762817955,1460,7,850,610,2,1950,540000
6762818330,1540,7,1180,360,3,1968,529950
6762818344,3070,9,3070,0,3,1995,529000
6762818434,2360,7,1180,1180,5,1961,525000
6762818707,1510,8,1510,0,3,1962,516130
6762818733,1540,6,770,770,3,1944,515000
6762819302,1620,7,1180,440,3,1968,498000
6762819315,2240,8,1620,620,3,1956,497000
6762819478,1960,7,1960,0,4,1965,490000
6762819737,2846,8,1976,870,4,2000,482000
6762819910,1650,7,1650,0,3,1977,476000
6762820622,1480,6,1480,0,3,1940,455000
6762820798,1310,8,1120,190,2,2006,450000
6762821010,2448,9,2448,0,4,2014,447055
6762821012,1740,7,1740,0,3,2012,447000
6762821595,1870,7,1210,660,3,1969,432000
6762821653,1440,7,1440,0,3,1954,430000
6762822294,1540,7,1540,0,4,1967,415000
6762822401,1520,8,1520,0,3,1996,413000
6762822474,1270,6,1270,0,3,1968,410000
6762822598,1510,8,1510,0,2,1978,406500
6762823062,1610,7,950,660,2,1996,397000
6762823075,2200,8,2200,0,4,2010,396800
6762823260,1640,6,1240,400,3,1983,390000
6762823479,1030,7,830,200,3,1924,385000
6762823641,1020,7,1020,0,3,1944,380000
6762823730,1800,8,1800,0,3,2011,379900
6762824331,1060,7,1060,0,3,1959,364500
6762824418,2130,7,1290,840,3,1983,360000
6762824504,1400,6,950,450,3,1943,359950
6762824563,940,6,940,0,3,1959,358000
6762824861,1322,8,1087,235,3,2005,350000
6762825530,2210,8,2210,0,4,1967,336000
6762825568,1830,7,1830,0,4,2004,335000
6762826014,1010,7,1010,0,3,1967,325000
6762826237,1770,8,1770,0,3,1990,320900
6762826266,2000,8,1400,600,3,1978,320000
6762826816,2330,8,2330,0,4,2004,308000
6762826828,2420,8,2420,0,4,1996,307999
6762827422,1240,6,1240,0,3,1952,294950
6762827895,1300,6,1300,0,3,1959,281000
6762828054,1430,7,900,530,3,1925,279000
6762828397,1540,7,1540,0,3,1972,270000
6762828398,1150,6,1150,0,2,1910,270000
6762828468,1520,7,1080,440,3,1981,269950
6762828622,1170,7,1170,0,3,1952,265000
6762829150,1170,7,1170,0,3,1968,252000
6762829630,1010,7,1010,0,3,1969,240000
6762829721,1280,6,1280,0,4,1950,239000
6762829722,710,6,710,0,2,1953,239000
6762830550,920,6,920,0,3,1948,210000
6762830627,820,5,820,0,2,1942,208000
6762830758,590,6,590,0,1,1944,202000
6762830793,1010,8,950,60,1,2007,200000
6762830865,1510,7,1510,0,3,1966,199000
6762831247,1250,7,1250,0,3,1958,170000
6762831283,1370,6,1370,0,3,1963,168000
6762810452,3170,10,2230,940,3,1975,1600000
6762810685,3760,11,1910,1850,5,1969,1380000
6762810803,1670,8,1670,0,5,1919,1300000
6762811090,4240,10,4240,0,4,1989,1160000
6762811628,3050,8,1950,1100,3,1950,975000
6762811809,3750,9,2030,1720,5,1981,942500
6762811901,3850,9,2910,940,5,1963,925000
6762811937,2380,8,2380,0,3,1963,921000
6762812024,3560,9,2930,630,4,2014,907687
6762812356,2260,8,1220,1040,4,1948,864000
6762812410,3290,10,3290,0,4,2003,856500
6762812471,4920,9,2730,2190,6,1960,850000
6762812563,2290,7,1490,800,4,1948,840500
6762812717,2890,9,2890,0,5,2003,825000
6762812822,1370,7,1370,0,3,1955,815000
6762813291,1720,8,1720,0,5,1915,775000
6762813614,2670,8,2020,650,4,1941,750000
6762813733,2290,8,2290,0,4,1972,745000
6762813777,3050,9,3050,0,4,2007,740000
6762814220,2770,9,2770,0,4,1988,711000
6762815252,3420,9,3420,0,4,2002,650000
6762815399,2330,9,2330,0,4,2004,645000
6762815453,1420,8,1070,350,2,1953,641000
6762815477,2500,9,2500,0,4,1991,640000
6762815665,1900,8,1720,180,5,1957,630000
6762815769,2570,9,2570,0,4,2000,625000
6762815770,1880,8,1280,600,3,1950,625000
6762816157,1800,7,1200,600,3,1941,607500
6762816163,2150,8,1240,910,4,1982,607000
6762816306,940,6,940,0,3,1945,600000
6762816307,1180,7,940,240,2,1909,600000
6762816656,2150,8,2150,0,3,1995,587000
6762816683,2050,9,2050,0,3,1989,585000
6762816941,2550,9,2550,0,4,2001,575000
6762817302,2350,9,2350,0,4,1990,561600
6762817424,2620,9,2620,0,3,1988,557500
6762817601,2380,8,2110,270,3,1934,550000
6762817835,2660,8,2660,0,3,1992,545000
6762818858,3180,8,3020,160,4,2004,510000
6762819029,2910,8,2910,0,4,2013,504058
6762819303,1620,7,1620,0,3,1900,498000
6762819357,2760,8,1510,1250,5,1968,495000
6762819479,2800,8,1680,1120,4,1977,490000
6762819480,1930,8,1930,0,3,2005,490000
6762820062,2180,7,2180,0,5,1982,473000
6762820124,1780,7,1230,550,3,1977,470000
6762820252,1140,7,1140,0,2,2005,466000
6762820996,1110,6,890,220,2,1937,448000
6762821068,2430,7,2430,0,4,1909,445000
6762821596,2190,9,2190,0,3,1994,432000
6762821615,1710,8,1710,0,3,1996,431000
6762821654,1440,7,1440,0,2,1990,430000
6762821833,1970,8,1970,0,3,1978,425500
6762822540,1320,7,1320,0,3,1969,409950
6762822551,1640,8,1640,0,2,1974,409000
6762822616,1010,7,1010,0,3,1954,405500
6762822737,1480,7,1480,0,3,1995,402500
6762822826,2300,7,2300,0,5,1905,400000
6762822946,1590,8,1590,0,3,1998,399950
6762823084,1970,7,1220,750,4,1968,396000
6762823261,1950,7,1250,700,3,1956,390000
6762823262,1440,7,720,720,1,1923,390000
6762823984,2220,7,1140,1080,4,1963,374000
6762824016,1890,7,1010,880,4,1969,372000
6762824066,2130,8,2130,0,4,2009,370000
6762824362,1460,7,1460,0,3,2008,362764
6762824652,1600,6,1080,520,3,1930,355000
6762824862,3200,8,2360,840,3,1978,350000
6762824863,1080,7,1080,0,2,1984,350000
6762825324,1800,7,1080,720,4,1979,340000
6762825325,1130,6,1130,0,3,1996,340000
6762825772,1510,7,1510,0,3,1985,330000
6762826433,1256,7,1256,0,3,2005,316750
6762826694,1210,7,1210,0,3,1953,310000
6762826866,1090,8,1090,0,2,2008,306000
6762826902,1030,7,1030,0,3,1924,305000
6762827030,2030,7,2030,0,4,1988,302000
6762827511,1280,5,1280,0,3,1941,291000
6762827874,1440,6,1130,310,2,1935,282500
6762827881,2010,7,2010,0,3,2006,282000
6762828182,2670,8,1420,1250,4,1962,275000
6762828183,1060,6,1060,0,3,1983,275000
6762828184,1300,7,1080,220,3,1976,275000
6762828286,2440,7,1220,1220,4,1963,274700
6762828333,1870,7,1870,0,4,2009,272000
6762828361,1890,7,1230,660,3,1979,271900
6762828737,1790,8,1330,460,3,1979,263000
6762829151,940,6,940,0,2,1926,252000
6762829221,1910,7,1000,910,4,1980,250000
6762829471,1470,8,1470,0,3,1974,245000
6762829590,2240,7,1120,1120,4,1966,242000
6762829739,1400,7,1400,0,4,1959,238000
6762829764,1160,7,1160,0,3,1958,237000
6762830341,1060,7,1060,0,3,1962,219000
6762830503,1040,6,1040,0,3,1951,212000
6762830691,1060,6,1060,0,2,1941,205000
6762830985,1840,7,1840,0,4,1994,190000
6762831059,1990,7,1990,0,5,1955,185000
6762831060,1510,6,1510,0,3,1975,185000
6762831167,840,6,840,0,3,1969,178000
6762831248,1350,7,1350,0,3,1966,170000
6762831558,550,5,550,0,2,1952,115000
6762810948,3680,11,3680,0,3,1999,1230000
6762811077,2670,9,2000,670,3,1942,1170000
6762811396,4475,9,4475,0,5,2014,1040000
6762811757,2700,9,2070,630,5,1926,950000
6762812183,3670,10,3670,0,4,1999,885250
6762812559,2170,8,2170,0,4,1960,842000
6762812622,3650,9,3650,0,4,2006,835000
6762812979,1630,8,1630,0,3,1919,800000
6762813163,2290,9,2290,0,4,1981,785000
6762813420,2980,10,2980,0,4,2006,765000
6762813591,3090,10,3090,0,3,1992,751000
6762813693,2010,8,1340,670,3,2014,749950
6762814145,1660,9,1660,0,3,2013,716000
6762814359,2590,9,2590,0,4,2004,700000
6762814444,3250,9,3250,0,4,2014,699188
6762814447,1670,7,1270,400,3,1952,699000
6762814635,2170,7,1220,950,4,1959,685000
6762814904,2500,7,1460,1040,4,1926,670000
6762814953,1770,8,1300,470,3,1963,667000
6762814979,1730,8,1730,0,3,1996,665000
6762815099,3550,9,3550,0,4,2014,659950
6762815153,1410,8,1410,0,3,1927,655000
6762815400,2340,7,1620,720,3,1914,645000
6762815545,2460,9,1840,620,5,1991,637000
6762815571,1530,7,1210,320,3,1997,635000
6762815666,2490,8,1540,950,5,1959,630000
6762815739,1040,7,860,180,3,1924,626000
6762815852,4170,9,3500,670,4,2007,623300
6762816471,1350,7,1350,0,4,1959,595000
6762817030,2340,8,2340,0,5,1973,572000
6762817197,2110,7,1110,1000,3,1965,565000
6762817198,1540,7,1540,0,4,1906,565000
6762817336,1960,8,1460,500,3,1989,560000
6762817602,1600,7,1110,490,3,1947,550000
6762817603,2290,8,2290,0,3,2001,550000
6762817746,1380,7,1380,0,3,1929,549900
6762817914,2360,8,2360,0,4,1977,542126
6762817956,2290,9,2290,0,4,2004,540000
6762818435,2500,7,2500,0,5,1968,525000
6762818599,1240,7,1240,0,4,1944,520000
6762818600,1360,7,1360,0,2,1932,520000
6762818601,1850,8,1370,480,3,1985,520000
6762818689,833,5,833,0,2,2006,517534
6762818734,2360,9,2360,0,3,1990,515000
6762819099,1710,8,1710,0,3,1994,500000
6762819635,1800,8,1800,0,3,1987,485000
6762819780,1940,8,1940,0,3,1994,480000
6762819781,3620,9,3620,0,4,1976,480000
6762819872,3274,9,3274,0,4,2014,478830
6762819953,1710,7,1510,200,2,1923,475000
6762820125,1010,7,1010,0,3,1952,470000
6762820194,1680,7,1170,510,3,1929,469000
6762820428,1490,7,1150,340,3,1963,460500
6762820450,1910,7,1010,900,5,1963,460000
6762820799,2390,7,1750,640,4,1949,450000
6762820800,1900,7,1150,750,2,1923,450000
6762820801,1520,7,1000,520,3,1955,450000
6762821144,1860,7,1860,0,4,1964,443000
6762821236,1950,7,1150,800,3,1979,440000
6762821655,1550,8,1550,0,3,2004,430000
6762821789,1350,7,1350,0,3,1944,427500
6762821822,2230,7,2230,0,2,1951,426000
6762822385,1590,7,1590,0,4,1956,414050
6762822988,2311,9,2311,0,4,2014,399440
6762823370,1350,8,1270,80,3,2006,389500
6762823590,2220,8,2220,0,3,1998,382450
6762823593,1790,7,1790,0,3,1953,382000
6762823720,2040,8,2040,0,3,1987,379950
6762823846,1330,8,1330,0,3,2004,375000
6762823847,1520,7,1520,0,3,1953,375000
6762824256,1380,8,1380,0,3,1976,365000
6762824419,1520,8,1220,300,3,1978,360000
6762824420,2140,7,2140,0,4,1959,360000
6762824585,1070,7,1070,0,3,1961,357500
6762824819,1160,7,1160,0,3,1960,351000
6762824826,1290,8,1290,0,2,1999,350500
6762824864,1970,7,1300,670,3,1979,350000
6762824865,1790,7,1090,700,3,1904,350000
6762825096,1010,7,1010,0,3,1968,347000
6762825154,1120,6,920,200,3,1905,345000
6762825326,1010,7,1010,0,3,1975,340000
6762825531,2820,8,2820,0,3,1986,336000
6762825569,2850,8,1540,1310,3,1989,335000
6762825709,1030,7,1030,0,3,1950,332500
6762826015,2160,8,2160,0,4,1994,325000
6762826184,1310,7,1310,0,4,1967,323000
6762826267,2610,8,1310,1300,4,1987,320000
6762826268,1820,8,1570,250,3,2008,320000
6762826396,1780,7,900,880,4,1974,318500
6762827098,2090,7,2090,0,3,2005,300000
6762827459,1110,6,1110,0,1,1935,293000
6762827647,1010,7,860,150,2,2007,289000
6762827725,1000,7,1000,0,2,1962,286300
6762828399,1850,7,1050,800,4,1965,270000
6762828487,1740,7,1110,630,3,1963,269900
6762828566,1890,7,1890,0,3,1964,267300
6762828810,1100,7,1100,0,3,1984,260000
6762828885,1578,7,1578,0,3,2010,259950
6762828911,1240,7,1240,0,3,1986,259000
6762829222,990,7,990,0,2,1981,250000
6762829414,1590,7,1590,0,3,1961,247200
6762829585,1400,7,1400,0,4,1935,242025
6762830076,1800,7,1800,0,2,1954,228000
6762830101,1410,7,1410,0,3,1965,226740
6762830426,1500,7,1500,0,3,1952,215000
6762830551,1450,7,850,600,2,1950,210000
6762830841,2270,6,1300,970,3,1948,199950
6762830961,1170,6,1170,0,3,1969,192950
6762831112,1850,7,1850,0,4,1954,181100
6762831274,890,6,890,0,3,1957,169000
6762831582,930,5,930,0,2,1932,105500
6762810879,2210,10,1500,710,2,2008,1260000
6762811078,4310,10,3260,1050,6,2013,1170000
6762811216,3190,8,2610,580,4,1956,1100000
6762811274,4800,10,4800,0,4,2011,1080000
6762811483,3090,8,2590,500,4,1919,1000000
6762811557,2160,8,1880,280,3,1939,990000
6762811675,2900,8,1450,1450,5,1959,968000
6762812145,2330,7,1720,610,4,1925,891000
6762812779,2830,9,2830,0,5,2010,820000
6762812924,1550,7,1550,0,2,1920,805000
6762813071,3160,10,3160,0,4,1987,795000
6762813164,2900,8,2410,490,4,1978,785000
6762813292,4130,10,4130,0,4,2011,775000
6762813355,3950,10,3950,0,4,2001,771150
6762813370,2160,8,2160,0,5,1926,770000
6762813371,3680,10,2390,1290,3,1985,770000
6762814495,2080,8,2080,0,3,1924,695000
6762814809,2260,9,2260,0,3,1977,675000
6762814937,2470,8,2470,0,4,2012,669000
6762815119,2430,9,2430,0,4,1992,658100
6762815140,1480,8,1480,0,3,1943,656000
6762815401,2860,8,2860,0,4,1995,645000
6762815572,2260,9,2260,0,4,1992,635000
6762815573,2240,8,2240,0,4,2013,635000
6762815745,1270,8,1060,210,3,2014,625504
6762815999,1910,8,1910,0,3,2001,615000
6762816657,3610,7,3610,0,5,1989,587000
6762816800,3550,7,3550,0,5,1960,580000
6762816801,2100,7,1300,800,3,1943,580000
6762818436,2110,8,2110,0,3,2001,525000
6762818859,1210,7,1210,0,2,1950,510000
6762819100,1760,8,1760,0,3,1978,500000
6762819481,1590,7,920,670,2,1946,490000
6762820126,1740,8,1360,380,3,2007,470000
6762820369,2300,7,1600,700,6,1920,464000
6762821069,2100,8,1620,480,3,1967,445000
6762821070,1490,7,1210,280,3,1974,445000
6762821138,2170,7,2170,0,3,2006,443500
6762821237,1550,7,1550,0,3,1996,440000
6762821375,1650,7,1650,0,3,2003,438000
6762821656,1620,7,1620,0,4,1943,430000
6762821859,1800,7,950,850,4,1955,425000
6762822170,2550,7,2550,0,4,2003,419500
6762822387,3045,8,3045,0,5,1999,414000
6762822827,2110,8,2110,0,3,1959,400000
6762822981,1320,7,870,450,4,1930,399700
6762823206,1950,7,1950,0,4,1961,392500
6762823480,1360,8,1360,0,3,2008,385000
6762823552,2320,7,1200,1120,6,1987,384000
6762823642,1860,8,1860,0,4,1966,380000
6762823848,940,7,940,0,2,1909,375000
6762823849,720,6,720,0,1,1920,375000
6762824257,2720,8,2100,620,4,1999,365000
6762824383,760,6,760,0,2,1941,361600
6762824421,2080,7,1040,1040,4,1962,360000
6762824422,1930,8,1260,670,3,1958,360000
6762824866,1250,7,1250,0,3,1990,350000
6762824867,1740,8,1740,0,2,2002,350000
6762825114,1400,7,1400,0,3,2003,346100
6762825327,1410,6,1410,0,3,1993,340000
6762825478,1860,7,1860,0,5,1980,338000
6762825570,1430,8,1430,0,3,2003,335000
6762826202,2140,8,2140,0,4,1986,322500
6762826636,2900,7,1950,950,5,1937,312000
6762827255,1920,8,1920,0,3,1982,299000
6762827938,1370,7,1370,0,3,1981,280000
6762828600,1490,7,1490,0,3,2002,265950
6762828623,1600,7,1600,0,2,1947,265000
6762828747,2259,7,1491,768,3,1908,262500
6762828811,2160,8,1360,800,4,1978,260000
6762828949,1210,7,1210,0,3,1962,257500
6762829152,1420,7,1420,0,3,1990,252000
6762829336,2080,6,2080,0,3,1950,249900
6762829337,1220,7,1220,0,3,1994,249900
6762829472,860,7,860,0,2,1948,245000
6762829723,1510,7,1510,0,3,1962,239000
6762829740,1610,7,1090,520,3,1959,238000
6762829814,1110,7,1110,0,3,1990,235000
6762829815,670,6,670,0,2,1903,235000
6762830107,1270,7,1270,0,4,1918,226000
6762830273,1400,7,1140,260,3,1985,220000
6762830692,1290,7,1290,0,3,1984,205000
6762830853,1798,7,1798,0,5,1967,199900
6762830882,1300,7,1300,0,3,1980,198000
6762831431,830,6,830,0,2,1943,150000
6762831591,770,7,770,0,2,1978,100000
6762810110,3730,10,3730,0,5,1963,2540000
6762810556,5180,12,4280,900,4,1998,1490000
6762811252,3460,9,1780,1680,4,1974,1090000
6762811804,2420,9,2000,420,4,1967,945000
6762811975,3390,8,1740,1650,3,1979,915000
6762812333,3190,9,3190,0,5,2014,865000
6762812869,3980,9,3980,0,4,2006,810000
6762812980,3691,8,3691,0,4,2013,800000
6762813260,2590,8,2590,0,5,2014,779380
6762813615,2620,8,2620,0,3,2013,750000
6762813812,2640,7,2140,500,5,1906,739375
6762813854,3100,9,3100,0,4,1990,735000
6762813911,2740,8,2740,0,4,1991,730000
6762813998,1530,8,1530,0,3,1985,725000
6762814158,3230,9,3230,0,3,2006,715000
6762814232,3130,8,3130,0,3,1978,710000
6762814294,2320,8,1380,940,2,1946,705000
6762814462,2990,9,2990,0,4,2001,698000
6762814586,1930,8,1540,390,4,1916,689888
6762814752,1420,8,1420,0,4,1928,679000
6762814764,1850,8,1210,640,3,1931,678100
6762814810,2620,9,2620,0,4,2011,675000
6762814905,1280,7,1280,0,3,1910,670000
6762814980,2600,8,1300,1300,2,1926,665000
6762814981,1620,8,1620,0,3,1929,665000
6762815522,2500,9,2500,0,4,1990,639000
6762815533,2170,8,1820,350,4,1978,638150
6762815771,1730,9,1730,0,3,2011,625000
6762816194,2330,7,1630,700,3,1940,605000
6762816555,2910,8,1780,1130,4,1975,590000
6762816556,2290,9,2290,0,4,1986,590000
6762817166,2064,7,2064,0,3,1903,567035
6762817542,2580,8,2580,0,4,2002,552250
6762817761,1920,8,1920,0,3,1981,549000
6762818106,2790,8,2790,0,4,2012,535365
6762818232,2540,8,1540,1000,5,1955,531000
6762818345,1940,9,1940,0,3,1990,529000
6762818390,2220,7,1110,1110,4,1959,526000
6762818546,2310,8,1480,830,4,1908,524000
6762818571,2340,8,1640,700,4,1977,522250
6762818735,2100,8,1660,440,3,2008,515000
6762819304,2480,8,2480,0,3,2009,498000
6762819316,1870,7,1350,520,3,1975,497000
6762819416,3760,8,2470,1290,4,2002,494500
6762819482,1720,7,1720,0,3,1956,490000
6762819587,3160,8,3160,0,3,2003,488000
6762819636,1150,7,1150,0,4,1909,485000
6762820127,3380,8,1690,1690,4,1969,470000
6762820282,2340,8,1170,1170,4,1983,465000
6762820802,1540,8,1540,0,3,1983,450000
6762821176,1960,7,1960,0,4,1962,442000
6762821470,1600,7,1600,0,3,2005,435000
6762821657,1350,8,1350,0,2,2004,430000
6762821658,3860,8,2300,1560,5,1955,430000
6762821659,1400,7,1400,0,3,1987,430000
6762822070,1060,7,1060,0,3,1983,420000
6762822178,1970,7,1970,0,3,2004,419000
6762822250,1270,7,1270,0,2,1932,416000
6762822441,1130,9,800,330,2,2007,411000
6762822475,1900,8,1900,0,4,1995,410000
6762822476,2510,8,1840,670,4,2012,410000
6762823117,1620,7,1210,410,3,1976,395000
6762823769,2740,8,2740,0,5,2005,378800
6762824556,1040,7,1040,0,2,1944,358803
6762824731,1830,7,1060,770,5,1962,354000
6762824868,2380,8,2380,0,4,1997,350000
6762825010,1640,7,1040,600,2,1948,349950
6762825467,1830,7,1830,0,4,2003,338900
6762825506,1010,7,1010,0,2,1947,337000
6762825661,870,7,870,0,2,1948,334850
6762825667,1650,6,1650,0,4,1960,334009
6762825773,1870,8,1870,0,3,2000,330000
6762825956,1900,7,1290,610,4,1948,327000
6762826016,2450,7,1770,680,3,1978,325000
6762826986,2140,7,2140,0,4,1990,304400
6762827043,1370,7,1370,0,3,1988,301950
6762827099,1460,7,1460,0,4,1958,300000
6762827664,1290,7,1060,230,3,2008,288790
6762827939,1580,8,1580,0,3,1992,280000
6762828055,1810,8,1470,340,4,1977,279000
6762828185,1320,7,1320,0,3,1959,275000
6762828400,1770,7,1420,350,3,1986,270000
6762828469,990,7,990,0,3,1961,269950
6762828738,1720,7,1720,0,3,1987,263000
6762828812,1270,6,1270,0,2,1977,260000
6762828999,1440,7,1150,290,2,1965,255500
6762829020,1590,7,1590,0,3,1994,255000
6762829021,1240,7,1240,0,3,1967,255000
6762829022,1530,7,1530,0,3,2005,255000
6762829102,1160,6,1160,0,3,1958,254000
6762829962,1240,6,1240,0,3,1948,230000
6762830357,840,6,840,0,2,1952,218450
6762830552,1040,7,1040,0,2,1954,210000
6762830628,1250,7,1250,0,3,1980,208000
6762830866,1390,7,1390,0,3,1964,199000
6762830955,960,6,960,0,3,1962,193000
6762831039,1310,6,850,460,2,1950,187300
6762831249,1280,6,1280,0,2,1912,170000
6762831384,770,6,770,0,3,1941,156000
6762831527,880,5,880,0,3,1950,128750
6762814702,2140,7,1070,1070,3,1952,680000
6762818659,1640,6,1640,0,4,1907,519000
6762823963,2790,8,2790,0,4,2004,374950
6762824611,2060,9,2060,0,3,2014,356250
6762830693,860,6,860,0,3,1944,205000
6762810404,3450,10,2640,810,4,1993,1670000
6762811349,3470,10,2560,910,3,1988,1050000
6762813405,2410,9,2220,190,6,1916,767500
6762813485,2990,10,2990,0,4,1988,760000
6762814960,2320,7,1620,700,4,1913,666570
6762817604,3820,8,2440,1380,4,1955,550000
6762823481,2370,7,1280,1090,3,1954,385000
6762824067,1310,7,1310,0,4,1940,370000
6762810315,3320,10,3320,0,4,1905,1800000
6762810565,4470,9,3240,1230,3,1953,1480000
6762810717,2390,9,1700,690,3,1952,1350000
6762810740,2760,9,1840,920,4,1938,1340000
6762811217,4410,9,4410,0,5,1990,1100000
6762812234,3590,10,3590,0,4,2005,879000
6762812573,2720,9,2720,0,4,1976,840000
6762812951,3320,10,3320,0,4,2005,802500
6762813293,1175,6,1175,0,3,1949,775000
6762813294,2890,10,2890,0,3,1996,775000
6762813486,2050,9,1600,450,3,1960,760000
6762813901,2630,9,2630,0,4,2006,731688
6762814360,2440,10,2440,0,4,1988,700000
6762814361,2190,7,1610,580,3,1973,700000
6762814552,2540,8,1500,1040,3,1959,690000
6762814769,1740,7,990,750,3,1923,677915
6762814811,1720,8,1030,690,3,2004,675000
6762814943,3990,9,2710,1280,5,2002,668000
6762814944,2670,8,2670,0,4,1999,668000
6762815253,2430,9,2430,0,3,1992,650000
6762815574,3880,7,3880,0,6,2003,635000
6762815772,1730,7,1730,0,3,1986,625000
6762815773,2470,8,2470,0,4,1979,625000
6762815774,2360,10,2360,0,3,1987,625000
6762816864,1990,8,1390,600,3,1926,579000
6762816910,2590,8,2590,0,4,2001,576000
6762817066,1530,8,1530,0,3,1998,570000
6762817280,2440,9,2440,0,4,1991,562500
6762817337,1840,7,1840,0,3,1968,560000
6762817338,2280,9,2280,0,4,1989,560000
6762817605,2420,7,2420,0,4,1945,550000
6762817747,1140,8,940,200,2,2014,549900
6762818060,3260,8,1960,1300,4,1978,538000
6762818356,2020,7,2020,0,3,2003,528000
6762818805,1620,7,920,700,3,1954,514000
6762818829,1170,8,1170,0,2,2007,512000
6762819036,2100,7,1240,860,4,1978,503000
6762819052,1710,7,1140,570,3,1921,502000
6762819101,2410,8,2410,0,3,1976,500000
6762819433,2760,7,1630,1130,4,1978,492500
6762819637,2870,9,2870,0,3,2008,485000
6762819954,1440,7,1440,0,2,1983,475000
6762820082,3800,8,3210,590,3,2005,472000
6762820093,3281,9,3281,0,4,2014,471835
6762820803,2080,8,1680,400,3,1977,450000
6762820945,3100,9,3100,0,4,1978,449950
6762821013,980,8,980,0,2,2010,447000
6762821330,3390,7,3390,0,5,2003,439900
6762821471,1650,7,1090,560,2,1960,435000
6762821804,2000,7,1360,640,3,1956,427000
6762821860,1150,7,1010,140,2,1922,425000
6762822566,1640,7,1640,0,3,1987,408000
6762822828,1390,7,930,460,3,1981,400000
6762823263,2154,9,2154,0,4,2012,390000
6762823547,2029,9,2029,0,3,2014,384435
6762823850,1370,7,1370,0,3,1968,375000
6762824068,1650,8,1650,0,3,2007,370000
6762824258,680,5,680,0,2,1901,365000
6762824385,1070,7,1070,0,3,1978,361500
6762824423,1330,7,1330,0,3,1975,360000
6762824505,2540,8,2540,0,3,1991,359950
6762824521,2470,8,2470,0,4,1983,359900
6762825084,1890,8,1890,0,3,1992,347500
6762825118,1500,8,1150,350,3,2007,346000
6762825495,2330,7,2330,0,4,2013,337500
6762825571,1560,7,1560,0,3,1961,335000
6762825572,2280,7,1140,1140,4,1963,335000
6762825650,2410,8,2410,0,4,1992,334950
6762825957,1510,7,1510,0,3,1964,327000
6762825972,1060,7,1060,0,3,1967,326250
6762826142,2050,7,1050,1000,3,1939,324950
6762826482,2200,8,1860,340,4,1991,315000
6762826777,1770,7,1770,0,4,1989,309950
6762827005,1850,8,1850,0,3,1993,303000
6762827100,1940,7,1940,0,5,1957,300000
6762827234,1530,6,1530,0,4,1976,299800
6762827437,820,6,820,0,2,1952,294000
6762827539,850,7,850,0,2,1948,290000
6762828624,1560,7,1560,0,3,1961,265000
6762828770,1740,7,1740,0,3,1990,261500
6762828777,1390,7,1390,0,4,1958,261000
6762829126,1400,7,1400,0,3,1968,253000
6762829431,1430,7,1430,0,3,1992,246500
6762829631,1090,6,1090,0,3,1961,240000
6762829904,1350,7,1350,0,3,1989,233000
6762829963,1450,7,1450,0,3,2003,230000
6762830041,1010,7,1010,0,3,1968,229900
6762830042,1440,7,1440,0,3,1968,229900
6762830108,1200,7,1200,0,4,1972,226000
6762830136,1030,6,1030,0,2,1959,225000
6762830427,1540,7,1040,500,4,1978,215000
6762830553,1520,6,1040,480,3,1951,210000
6762830554,1920,6,1920,0,3,1953,210000
6762830599,700,5,700,0,2,1953,209995
6762830640,890,6,890,0,2,1917,207950
6762831162,740,6,740,0,2,1953,178500
6762831194,1030,7,1030,0,3,1954,175000
6762810896,4520,10,3270,1250,4,1992,1250000
6762811484,2610,8,1920,690,4,1922,1000000
6762811970,3500,10,3500,0,4,1995,917000
6762812292,3600,9,2940,660,4,2014,870515
6762812321,1900,7,1100,800,2,1954,869000
6762812525,3160,8,3160,0,6,1989,848750
6762812614,2380,9,2380,0,4,1963,835100
6762812870,2910,9,2910,0,4,2005,810000
6762813063,3670,9,2870,800,4,2005,796000
6762813099,1510,7,1510,0,4,1911,791500
6762813220,2270,9,1310,960,4,1975,780000
6762813221,3390,8,2190,1200,4,1924,780000
6762813421,2440,8,1740,700,5,1944,765000
6762813487,1410,7,1310,100,2,1925,760000
6762813616,3270,10,3270,0,3,1982,750000
6762813778,2720,9,1830,890,5,1988,740000
6762813912,3550,9,3550,0,4,1991,730000
6762813999,2990,9,2990,0,4,1999,725000
6762814362,2190,8,2190,0,3,2004,700000
6762814448,2580,10,2090,490,3,1956,699000
6762814553,3730,10,2460,1270,4,1990,690000
6762814950,2660,8,2660,0,4,1977,667400
6762814954,2510,8,2510,0,3,2007,667000
6762815402,2070,7,1130,940,3,1946,645000
6762815478,2390,9,2390,0,3,1990,640000
6762815523,2210,9,2210,0,4,1990,639000
6762815718,4000,9,2190,1810,3,1987,628000
6762815775,3240,9,3240,0,5,2007,625000
6762815896,2190,8,2190,0,3,1990,620000
6762816000,1470,8,1470,0,3,2003,615000
6762816093,2930,9,1520,1410,5,1975,610000
6762816557,2300,8,1580,720,3,1960,590000
6762816638,2580,8,2580,0,4,1977,588000
6762816684,1740,8,1150,590,3,1958,585000
6762817151,1930,7,1300,630,3,1980,568000
6762817957,2600,8,2600,0,4,2005,540000
6762818666,2810,9,2810,0,4,2014,518380
6762818860,3300,8,3300,0,6,1980,510000
6762818861,3300,8,3300,0,6,1980,510000
6762819031,1560,9,1560,0,3,2009,503045
6762819358,2240,7,2240,0,3,1953,495000
6762819603,1770,7,1770,0,3,1944,487000
6762819752,2290,7,1400,890,3,1967,481000
6762819782,1580,7,1050,530,3,1977,480000
6762819955,2630,9,2630,0,3,1991,475000
6762820128,1850,7,1210,640,4,1981,470000
6762820129,3910,9,2710,1200,5,2000,470000
6762820529,1480,8,1480,0,2,2008,459000
6762820729,2270,6,1270,1000,3,1900,452000
6762820755,2260,7,1330,930,5,2003,451000
6762821003,2320,8,2320,0,3,1990,447500
6762821238,1790,7,1790,0,3,2007,440000
6762821555,1830,8,1830,0,3,1991,434000
6762821861,1380,7,1380,0,3,1942,425000
6762822071,2280,8,1270,1010,4,1989,420000
6762822947,1850,6,1110,740,4,1945,399950
6762823377,1340,8,1340,0,2,2007,389000
6762823643,920,6,920,0,3,1910,380000
6762823644,1750,7,1750,0,3,1968,380000
6762824008,1400,8,1400,0,2,2007,372500
6762824259,980,7,780,200,2,1939,365000
6762824424,1300,7,1300,0,3,1967,360000
6762824564,1278,7,1002,276,2,2007,358000
6762824612,1690,7,940,750,3,1928,356200
6762824869,2100,7,1690,410,3,2005,350000
6762824870,1280,8,1060,220,2,2006,350000
6762825047,2280,7,2280,0,4,2003,349000
6762825423,1320,8,1320,0,3,1959,339950
6762825507,2610,8,2610,0,4,2004,337000
6762825532,1780,6,1780,0,4,1919,336000
6762825573,1380,7,1380,0,2,1988,335000
6762825574,2060,8,1600,460,3,1976,335000
6762826143,2229,7,2229,0,4,2012,324950
6762826353,2038,8,2038,0,4,2011,319950
6762826903,2100,8,2100,0,4,1998,305000
6762827022,1095,7,1095,0,2,1901,302282
6762827031,1110,7,1110,0,3,1955,302000
6762827256,1070,6,1070,0,2,1942,299000
6762827305,1852,7,1852,0,3,2014,298000
6762827366,1850,7,1850,0,4,1993,295000
6762827438,850,7,850,0,2,1950,294000
6762827502,1310,7,1310,0,3,1950,291750
6762827648,1690,7,1690,0,3,1987,289000
6762828046,1200,7,1200,0,3,1959,279500
6762828056,1320,7,1320,0,3,1913,279000
6762828057,1560,7,1560,0,4,1966,279000
6762828186,1000,7,1000,0,3,1969,275000
6762828334,2115,7,2115,0,4,1998,272000
6762828470,1660,8,1660,0,3,1987,269950
6762828471,1760,7,1460,300,3,1956,269950
6762828625,1780,8,1780,0,3,1989,265000
6762828626,2200,8,1270,930,3,1962,265000
6762828934,1390,7,1390,0,3,1996,258000
6762828950,1360,7,1360,0,4,1968,257500
6762829023,1760,7,1140,620,4,1971,255000
6762829223,1250,7,1250,0,3,1960,250000
6762830428,1500,7,1500,0,4,1999,215000
6762830429,1610,7,1610,0,4,1969,215000
6762830604,1570,7,1570,0,3,1981,209950
6762830605,1630,6,1630,0,4,1962,209950
6762830900,2070,7,2070,0,3,1974,196000
6762831021,1000,5,1000,0,2,1914,189900
6762831042,1730,7,1730,0,3,2005,187000
6762831432,1360,7,1360,0,2,1978,150000
6762831607,840,6,840,0,3,1960,86500
6762810566,3920,10,3120,800,4,1928,1480000
6762810686,3786,9,1934,1852,3,1978,1380000
6762810804,4120,11,4120,0,4,2005,1300000
6762811147,3740,10,3740,0,4,2014,1140000
6762811554,2290,9,1610,680,4,1924,991700
6762812098,2580,8,2580,0,4,2013,899000
6762812167,3080,9,3080,0,4,2014,889950
6762812199,4210,9,4210,0,4,2001,884744
6762812230,3020,9,3020,0,4,2014,879950
6762812288,3770,9,1940,1830,4,1967,872000
6762812334,3830,9,3830,0,3,1977,865000
6762812472,3380,9,1690,1690,4,1979,850000
6762812473,2500,7,2500,0,4,1955,850000
6762812623,4480,9,4480,0,4,1987,835000
6762812780,2210,8,1440,770,2,1931,820000
6762812844,2530,8,2220,310,4,1964,813500
6762813270,1840,7,1720,120,3,1946,778000
6762813393,3360,9,3360,0,5,2014,769995
6762813394,3010,9,3010,0,5,2014,769995
6762813402,3030,8,3030,0,5,1980,768000
6762813617,2630,8,2630,0,2,2003,750000
6762813712,3170,7,2570,600,4,1925,748000
6762814295,2180,7,1140,1040,3,1946,705000
6762814554,1300,7,1300,0,3,1920,690000
6762814636,3450,8,2970,480,3,1927,685000
6762815188,2460,9,2460,0,4,2003,653750
6762815776,1410,8,1410,0,4,1927,625000
6762816082,2610,9,2610,0,4,2013,610360
6762816558,2420,8,2420,0,3,2005,590000
6762816652,1190,7,1190,0,2,1946,587100
6762816685,1860,8,1460,400,4,1966,585000
6762816886,2000,9,2000,0,3,1995,577500
6762816942,2680,8,1580,1100,3,1978,575000
6762817291,3290,8,2330,960,3,1975,562000
6762817429,1630,8,1630,0,3,2004,557000
6762817531,2700,8,1760,940,3,1907,552500
6762817556,1470,7,1470,0,4,1946,551000
6762817606,1420,9,1340,80,3,2007,550000
6762817732,3906,9,3906,0,4,2014,549950
6762817781,1470,7,1170,300,2,1916,548000
6762817836,3410,9,3410,0,4,1984,545000
6762818128,2560,6,1280,1280,2,1944,535000
6762818265,2370,8,1570,800,4,1976,530000
6762818862,3300,8,3300,0,6,1980,510000
6762819102,1580,8,1580,0,3,1994,500000
6762819483,2510,8,2510,0,4,2010,490000
6762819638,2420,7,1210,1210,4,1958,485000
6762819783,1640,8,1640,0,3,1987,480000
6762820283,2150,8,2150,0,3,2007,465000
6762820623,2480,7,2050,430,4,1913,455000
6762820624,2090,8,2090,0,4,2011,455000
6762820804,1760,8,1760,0,3,1983,450000
6762820946,1530,8,1530,0,3,1994,449950
6762821239,2070,7,1330,740,3,1929,440000
6762821320,1540,8,1540,0,3,1982,439950
6762821472,2440,7,2440,0,4,2003,435000
6762821560,1230,7,780,450,3,1937,433500
6762821660,2630,7,1610,1020,6,1959,430000
6762821862,1540,7,1540,0,3,1988,425000
6762821863,1340,7,1190,150,5,1962,425000
6762821864,1280,7,1280,0,3,1903,425000
6762821993,2950,8,2950,0,4,1960,424900
6762822072,1060,7,1060,0,2,1977,420000
6762822073,2030,7,1150,880,4,1973,420000
6762822295,1470,7,1070,400,3,1979,415000
6762822442,1490,7,1190,300,3,1959,411000
6762822477,1790,7,1380,410,3,1985,410000
6762823174,1090,7,1090,0,3,1957,394950
6762823183,1160,6,580,580,3,1930,394000
6762823238,890,6,890,0,2,1946,391000
6762823264,1840,8,1840,0,4,1991,390000
6762823355,1890,7,1890,0,4,1968,389999
6762823742,1830,8,1830,0,3,1989,379500
6762823851,2840,8,1470,1370,5,1975,375000
6762823852,1110,6,1110,0,3,1940,375000
6762824653,940,7,940,0,3,1967,355000
6762824871,1130,6,1130,0,3,1948,350000
6762825233,1060,6,770,290,2,1932,344000
6762825508,1470,7,1470,0,3,1999,337000
6762825575,1400,7,1400,0,3,1965,335000
6762826017,2330,7,1480,850,3,1980,325000
6762826173,1540,7,1540,0,3,1989,324000
6762826695,1990,7,1990,0,3,2004,310000
6762826696,1560,6,780,780,2,1947,310000
6762827032,2140,8,2140,0,3,1994,302000
6762827257,1940,8,1630,310,3,1966,299000
6762827367,1830,7,1830,0,4,2003,295000
6762827875,1670,7,1670,0,3,1990,282500
6762827896,1760,8,1760,0,3,1992,281000
6762827940,2280,7,2280,0,2,1932,280000
6762828322,1280,6,1280,0,2,1941,272925
6762828335,1790,8,1790,0,3,1998,272000
6762828912,1210,5,1210,0,2,1948,259000
6762828988,880,5,880,0,3,1924,256000
6762829224,2030,7,1310,720,3,1969,250000
6762829354,1860,7,1400,460,4,1962,249000
6762829632,1260,7,1260,0,3,1984,240000
6762829704,1460,7,730,730,4,1941,239950
6762829964,1430,7,930,500,2,1949,230000
6762830116,1440,6,1440,0,4,1962,225500
6762830203,2260,7,1520,740,4,1965,224950
6762830224,1200,7,1200,0,4,1961,223000
6762830430,1430,7,900,530,3,1946,215000
6762831031,1240,8,1240,0,2,1985,188500
6762831250,1920,7,1920,0,4,1962,170000
6762831301,1000,6,1000,0,4,1943,165000
6762831320,1050,7,1050,0,2,1996,163500
6762810263,3020,8,2840,180,6,1942,1900000
6762810357,4490,10,3090,1400,4,1941,1720000
6762811584,4030,11,4030,0,4,1988,985000
6762811645,3090,8,2420,670,4,1985,974350
6762811692,3830,9,3830,0,4,2014,963990
6762812035,3520,10,3520,0,4,1993,905000
6762812120,3555,9,3555,0,4,2014,895990
6762812474,3360,9,3360,0,2,2004,850000
6762812539,3460,10,3460,0,3,1986,845000
6762812540,2940,9,2940,0,4,2004,845000
6762812624,3600,8,1800,1800,5,1960,835000
6762812718,2770,9,2770,0,4,1979,825000
6762812719,3730,9,2960,770,3,1979,825000
6762813055,3500,10,3500,0,4,1987,798000
6762813112,2640,10,2640,0,4,1990,790000
6762813187,3540,8,1970,1570,4,1947,784000
6762813222,1970,8,1970,0,3,1924,780000
6762813295,2070,8,1250,820,4,1976,775000
6762813530,3000,8,3000,0,4,2008,759900
6762814000,3300,9,3300,0,4,1998,725000
6762814146,2270,10,2270,0,3,1988,716000
6762814637,2670,9,2670,0,5,1958,685000
6762814873,2740,9,2740,0,4,1997,672800
6762814884,2440,9,2440,0,4,1989,672000
6762815183,2240,8,1540,700,4,1962,654000
6762815254,2020,9,1620,400,4,1967,650000
6762815897,2290,7,1550,740,4,1928,620000
6762816094,2410,9,2410,0,4,1990,610000
6762816268,1950,7,1040,910,4,1951,601000
6762816802,3210,7,1810,1400,4,1975,580000
6762817020,2150,8,2150,0,4,1979,573000
6762817557,940,6,940,0,3,1900,551000
6762817762,1980,7,1220,760,2,1906,549000
6762817815,1980,8,1980,0,4,1989,545800
6762818103,1610,7,1010,600,3,1901,535610
6762818266,1370,7,1370,0,3,1906,530000
6762818346,1320,8,990,330,2,2014,529000
6762818541,1710,8,1710,0,3,1999,524250
6762818602,2000,6,1860,140,4,1949,520000
6762818712,2710,8,2710,0,5,2014,515805
6762819103,1360,8,1140,220,3,2006,500000
6762819237,1440,7,1440,0,3,1908,499950
6762819253,2180,7,2180,0,4,1968,499900
6762819639,2790,8,2790,0,4,2013,485000
6762819706,2790,8,2790,0,4,2014,484259
6762820130,2680,7,1530,1150,4,1967,470000
6762820805,1990,7,1990,0,3,1986,450000
6762821037,1730,7,1730,0,4,1949,446000
6762821616,1450,7,1250,200,4,1902,431000
6762821865,2120,7,1060,1060,4,1960,425000
6762822179,2140,7,1570,570,3,1958,419000
6762822296,2060,7,1220,840,5,1978,415000
6762822478,1740,7,1740,0,3,2008,410000
6762822479,1180,7,1120,60,2,2001,410000
6762822541,990,6,990,0,2,1918,409950
6762823029,2050,7,2050,0,4,1989,398000
6762823118,2130,8,1840,290,3,2011,395000
6762823433,2950,8,1950,1000,3,1963,386500
6762823755,3000,7,1500,1500,5,1961,379000
6762823853,1870,8,1720,150,3,1937,375000
6762823854,1610,7,1090,520,3,1975,375000
6762823855,1890,8,1890,0,3,1999,375000
6762824215,810,7,810,0,3,1968,367000
6762824371,710,6,710,0,2,1909,362362
6762824758,1260,6,1260,0,3,1942,353000
6762825103,2040,8,2040,0,3,2006,346950
6762825454,1150,7,1150,0,3,1966,339000
6762825576,1000,6,940,60,2,1906,335000
6762825577,1440,7,840,600,2,1950,335000
6762825578,2031,9,2031,0,3,1988,335000
6762825579,1730,7,1150,580,3,1980,335000
6762825774,2170,7,1340,830,3,1919,330000
6762826018,1810,7,1290,520,3,1983,325000
6762826398,1820,7,1820,0,4,1994,318400
6762826483,1660,7,1660,0,3,1994,315000
6762826637,1160,6,1160,0,2,1941,312000
6762826904,1400,7,1400,0,3,1976,305000
6762827368,830,6,830,0,3,1942,295000
6762827439,1380,7,1140,240,2,2012,294000
6762827506,1770,7,1770,0,4,2004,291500
6762827540,770,7,770,0,2,2006,290000
6762827721,1220,6,1220,0,3,1958,286700
6762828502,1440,7,1440,0,3,2005,269000
6762829119,1239,7,1239,0,3,2009,253101
6762829402,2290,6,2290,0,4,1936,247500
6762829965,1300,7,1300,0,3,1958,230000
6762830077,1060,6,1060,0,2,1951,228000
6762830137,1470,7,1160,310,3,1984,225000
6762830138,1220,7,1220,0,3,1931,225000
6762830321,990,7,990,0,2,1948,219950
6762830399,1580,7,1580,0,3,1977,216000
6762830741,1630,7,1630,0,3,1960,203000
6762831367,1360,7,1360,0,3,1953,159000
6762831433,850,4,850,0,2,1950,150000
6762810168,5150,11,4170,980,3,1954,2250000
6762810177,3620,10,2370,1250,3,1977,2230000
6762810242,4065,10,4065,0,4,1987,1950000
6762810340,3910,8,3910,0,4,1908,1750000
6762810358,4590,10,4590,0,5,2008,1720000
6762810770,2680,9,1820,860,3,1964,1320000
6762810805,4060,9,2660,1400,4,1924,1300000
6762810806,3350,9,2180,1170,3,2009,1300000
6762810928,4670,11,3820,850,4,2007,1240000
6762811043,2390,10,1980,410,3,1948,1190000
6762812146,3420,9,3420,0,4,2006,890900
6762812255,2350,8,1990,360,3,1922,875000
6762812871,3140,10,3140,0,3,1991,810000
6762813113,2370,9,1590,780,3,1977,790000
6762813223,2130,8,1590,540,3,1977,780000
6762813458,3330,10,3330,0,3,1986,762500
6762813618,2230,8,1150,1080,5,1960,750000
6762813913,2040,7,1340,700,3,1952,730000
6762814159,2370,8,1660,710,4,1974,715000
6762814363,1570,8,1570,0,3,1908,700000
6762814765,2640,9,2640,0,3,2003,678000
6762814812,2550,7,1850,700,3,1924,675000
6762814864,1920,9,1920,0,3,2003,674000
6762814888,2130,8,2130,0,4,1977,671500
6762814955,1900,7,1180,720,5,1930,667000
6762814982,3136,8,3136,0,3,1910,665000
6762815191,2070,8,1540,530,3,1980,653450
6762815255,2390,8,1470,920,4,1979,650000
6762815575,2490,9,2490,0,4,1997,635000
6762815710,1510,7,1510,0,3,1909,629000
6762815777,1990,7,1990,0,3,1926,625000
6762816445,2310,8,2310,0,4,1984,597750
6762816472,3130,9,2210,920,3,1985,595000
6762816530,1870,8,1870,0,2,2006,592500
6762816559,2160,7,1080,1080,4,1969,590000
6762816752,2200,8,1100,1100,4,1955,583000
6762817168,2100,8,1600,500,5,1974,567000
6762817339,2170,8,2170,0,4,1992,560000
6762817607,2050,8,2050,0,4,1987,550000
6762817608,2340,7,1540,800,3,1906,550000
6762817729,1120,7,1120,0,3,1943,549995
6762817958,1120,7,1120,0,2,1971,540000
6762817959,2993,7,2233,760,4,1921,540000
6762818574,1630,7,1630,0,3,1958,522000
6762818671,2640,8,1770,870,4,1977,518000
6762819104,2150,7,1470,680,3,1928,500000
6762819105,1420,8,1420,0,3,2006,500000
6762819450,2100,8,1400,700,4,1979,491500
6762819843,2260,9,2260,0,3,2012,479950
6762820063,1890,8,1890,0,3,1978,473000
6762820131,3520,8,2760,760,3,2005,470000
6762820212,2250,7,1330,920,4,1958,468000
6762820213,1630,7,1630,0,3,2004,468000
6762820451,2200,8,2200,0,4,2010,460000
6762820584,1290,7,1290,0,3,1919,456500
6762820625,2180,7,1750,430,3,1973,455000
6762820749,1420,8,1140,280,3,2008,451300
6762821071,1620,7,590,1030,3,2006,445000
6762821612,1360,7,1060,300,5,1966,431200
6762821661,1580,8,1290,290,3,1939,430000
6762821662,990,6,990,0,2,1931,430000
6762821663,1350,7,1350,0,4,1964,430000
6762821748,1430,7,1430,0,3,1984,429000
6762822180,2180,8,1280,900,4,1969,419000
6762822480,1350,8,1350,0,2,2007,410000
6762822481,2910,7,2910,0,5,2006,410000
6762823743,2070,7,2070,0,3,1989,379500
6762824260,1600,7,1600,0,5,1927,365000
6762824425,1550,7,1550,0,5,1941,360000
6762824872,2610,8,2610,0,4,2005,350000
6762825097,2770,8,2770,0,4,1989,347000
6762825155,1983,9,1983,0,4,2012,345000
6762825328,1090,6,1090,0,2,1954,340000
6762825329,2230,8,2230,0,4,2005,340000
6762825330,2270,8,2270,0,3,1986,340000
6762826019,2110,8,2110,0,4,1991,325000
6762826144,1240,7,1240,0,3,1976,324950
6762826347,1890,7,1890,0,4,1962,319990
6762826423,1790,7,1390,400,3,1980,317000
6762826658,1640,7,1640,0,3,1960,311000
6762826697,1480,7,1480,0,4,1969,310000
6762827047,1060,7,1060,0,3,1956,301000
6762827258,1730,7,1730,0,3,1959,299000
6762827882,2390,7,2390,0,4,1989,282000
6762827941,1834,8,1834,0,4,2012,280000
6762828187,2497,8,2497,0,3,2007,275000
6762828188,1080,5,1080,0,4,1900,275000
6762828555,1390,7,1390,0,3,2001,267500
6762828813,1670,7,1670,0,3,1988,260000
6762828814,1170,6,1170,0,3,1902,260000
6762828997,1489,7,1489,0,3,2014,255900
6762829225,1190,7,990,200,3,1954,250000
6762829888,1750,7,1750,0,3,1961,234000
6762829966,1410,7,1410,0,5,1967,230000
6762830139,1370,7,1370,0,3,1962,225000
6762830431,1847,7,1847,0,4,2008,215000
6762830484,1560,7,1560,0,3,1990,213675
6762831098,870,6,870,0,3,1969,183000
6762831316,1250,7,1250,0,3,1980,164808
6762831414,700,4,700,0,2,1920,152000
6762831559,940,6,940,0,2,1943,115000
6762831566,1080,6,1080,0,1,1963,112000
6762814233,2700,8,1450,1250,4,1937,710000
6762814620,2130,8,2130,0,4,1977,686000
6762815117,1410,8,1410,0,2,1927,658500
6762818992,1020,7,880,140,3,1928,505000
6762824873,1210,8,1000,210,3,2002,350000
6762830555,1000,8,1000,0,2,1975,210000
6762830694,900,6,900,0,2,1918,205000
6762831302,910,6,910,0,3,1943,165000
6762827724,1220,7,1220,0,2,2006,286308
6762810139,5860,10,3690,2170,4,1907,2400000
6762810567,4070,11,4070,0,3,1991,1480000
6762810718,4800,11,3480,1320,5,1998,1350000
6762811091,2380,9,1930,450,3,1939,1160000
6762811182,3840,10,3840,0,4,1983,1120000
6762811253,3010,9,3010,0,4,1980,1090000
6762811350,2750,10,2750,0,4,1999,1050000
6762811442,2920,8,1460,1460,3,1955,1020000
6762811656,3890,11,3060,830,4,2004,970000
6762811672,4120,11,3070,1050,4,2006,968933
6762811758,2150,8,1870,280,3,1921,950000
6762811902,2610,9,1660,950,3,1909,925000
6762811943,3650,7,2200,1450,3,1947,920000
6762812475,3900,8,2620,1280,5,1931,850000
6762813296,3090,9,3090,0,4,2001,775000
6762814432,3370,9,3370,0,3,1988,699950
6762814555,2120,9,2120,0,4,1989,690000
6762814556,1580,8,1580,0,3,1905,690000
6762814611,3320,7,2020,1300,5,1963,687500
6762814983,2970,8,2970,0,4,1924,665000
6762815217,2260,8,1660,600,3,2002,651000
6762815256,1550,7,1250,300,3,1911,650000
6762815667,2240,7,1250,990,4,1926,630000
6762815668,1770,7,1350,420,4,1937,630000
6762815730,3570,7,3570,0,5,2005,627000
6762815778,1750,8,1410,340,4,1977,625000
6762816560,1990,8,1310,680,3,1997,590000
6762816561,1530,8,1530,0,3,1901,590000
6762816686,2350,8,1520,830,5,1922,585000
6762816687,1480,7,1140,340,3,1944,585000
6762816743,2480,8,2480,0,3,2002,583800
6762817031,2360,8,1690,670,3,1987,572000
6762817199,960,7,960,0,2,1911,565000
6762817200,1720,7,1270,450,3,1931,565000
6762817460,2410,9,2410,0,3,1988,555000
6762817960,1990,9,1990,0,4,1984,540000
6762818129,2710,9,2710,0,4,1995,535000
6762818373,1170,7,1170,0,2,1910,527500
6762818547,1450,6,750,700,2,1924,524000
6762818564,1640,7,870,770,4,1943,522500
6762818688,3050,8,1800,1250,5,1966,517850
6762818959,1490,7,1020,470,4,2005,507000
6762819261,1620,7,1620,0,3,1954,499100
6762819317,770,7,770,0,2,1918,497000
6762819911,2740,9,2740,0,4,1993,476000
6762820185,1530,7,1030,500,2,1942,469775
6762820353,1200,8,1030,170,3,2008,464950
6762820559,3217,8,2587,630,4,2008,458000
6762820601,1690,7,1690,0,3,2002,455800
6762820730,2660,7,2660,0,6,1937,452000
6762821160,2800,7,1400,1400,6,1968,442500
6762821473,1840,7,1840,0,3,2008,435000
6762821866,2060,7,1540,520,4,1967,425000
6762822000,2200,9,2200,0,3,1985,424000
6762822074,1720,6,860,860,3,1940,420000
6762822443,1590,9,1590,0,2,1997,411000
6762822585,1810,7,1810,0,3,1967,407450
6762822745,1790,7,1330,460,3,1980,402200
6762822975,2710,8,2710,0,4,1994,399900
6762823856,2760,9,2110,650,3,1991,375000
6762824036,1690,7,1690,0,4,1977,371000
6762824426,2210,8,2210,0,4,1997,360000
6762824555,1710,7,1400,310,3,2014,358990
6762825104,1830,7,1830,0,3,1963,346950
6762825293,3070,8,3070,0,5,2005,341950
6762825331,2380,8,2380,0,4,2000,340000
6762825931,700,6,700,0,2,1943,328000
6762826185,1830,7,1200,630,3,1947,323000
6762826376,960,7,960,0,2,1951,319000
6762826484,1600,8,1600,0,3,1993,315000
6762826638,2440,8,1440,1000,3,1977,312000
6762826884,1300,7,1300,0,3,1956,305240
6762826905,2250,7,1340,910,4,1982,305000
6762827048,2810,9,2810,0,4,1998,301000
6762827101,720,6,720,0,3,1947,300000
6762827259,1590,7,1590,0,3,1994,299000
6762827301,2420,7,1420,1000,3,1959,298500
6762827772,2510,8,1290,1220,4,1962,285000
6762827773,1930,6,1930,0,3,1929,285000
6762828189,2060,7,2060,0,4,1999,275000
6762828190,1870,7,1870,0,3,1989,275000
6762828491,1830,8,1830,0,4,2012,269800
6762829000,1370,5,1370,0,4,1900,255500
6762829226,1530,7,1530,0,3,2001,250000
6762829227,1460,7,1460,0,3,1959,250000
6762829607,1520,8,1520,0,3,1993,241000
6762829967,1040,6,1040,0,3,1941,230000
6762830342,1090,7,1090,0,3,1990,219000
6762830432,1180,7,1180,0,3,1967,215000
6762830433,1180,7,1180,0,3,1970,215000
6762831038,840,6,840,0,3,1959,187500
6762831104,1500,7,1500,0,4,2014,182568
6762831109,1960,7,1290,670,3,1965,182000
6762831287,1280,6,1280,0,3,1985,167000
6762810060,5090,12,5090,0,5,2006,3100000
6762810085,5760,12,4390,1370,4,1994,2880000
6762810289,5240,10,5240,0,4,2006,1860000
6762810643,3960,9,2630,1330,4,1925,1400000
6762810754,6400,10,3810,2590,3,1966,1330000
6762810771,3470,11,2270,1200,4,1989,1320000
6762811218,3310,9,1660,1650,4,1973,1100000
6762811485,1780,8,1780,0,4,1918,1000000
6762811538,3200,9,2650,550,3,1914,995000
6762811817,3160,10,3160,0,4,1980,940000
6762811873,2900,8,1530,1370,4,1959,930000
6762811944,3660,10,3660,0,3,2003,920000
6762812335,1800,8,1800,0,4,1921,865000
6762812520,2960,10,2960,0,3,1995,849000
6762812574,3130,10,3130,0,4,1993,840000
6762812781,2920,10,2920,0,4,2002,820000
6762812823,2060,8,2060,0,4,1949,815000
6762812981,2930,9,2760,170,4,2007,800000
6762813040,3400,9,3400,0,4,2004,799000
6762813165,3230,9,3230,0,4,1993,785000
6762813619,3080,8,3080,0,4,2008,750000
6762813620,2520,8,1420,1100,4,1960,750000
6762813621,2960,9,2960,0,3,1990,750000
6762813779,3760,9,2950,810,4,1998,740000
6762813903,2060,8,1160,900,3,1953,731100
6762814280,1980,8,1980,0,3,1919,707000
6762814703,1620,7,1110,510,3,1950,680000
6762815064,2540,7,1510,1030,5,1925,660000
6762815669,2670,9,1780,890,4,1930,630000
6762815779,2100,8,2100,0,4,1978,625000
6762816195,2660,7,1330,1330,3,1922,605000
6762816196,2510,9,2510,0,4,1979,605000
6762816308,2810,8,1640,1170,4,1978,600000
6762816473,3090,7,1590,1500,4,1974,595000
6762816474,2910,8,2910,0,4,1998,595000
6762816562,2110,9,2110,0,3,2004,590000
6762816803,2330,7,1710,620,4,1983,580000
6762816943,3930,9,3930,0,4,1997,575000
6762816944,3240,8,3240,0,3,2001,575000
6762817340,2880,8,1440,1440,5,1966,560000
6762817392,2650,8,2250,400,4,1979,559950
6762817763,2420,8,1350,1070,4,1985,549000
6762817837,1910,7,1210,700,4,1953,545000
6762817899,1540,8,1540,0,3,2004,543000
6762818026,2500,8,2500,0,3,2001,539900
6762818130,2740,10,2740,0,3,1988,535000
6762818267,1970,7,1970,0,3,2011,530000
6762818736,1570,8,1200,370,3,1974,515000
6762818830,2600,9,2600,0,4,2005,512000
6762819024,1900,8,1900,0,2,2005,504975
6762819106,1250,7,1250,0,2,1957,500000
6762819595,2810,9,2810,0,4,2013,487500
6762819640,2140,7,1220,920,5,1962,485000
6762820409,2840,7,2210,630,5,1954,462000
6762820420,1260,7,1260,0,4,1951,461000
6762820573,2050,8,2050,0,3,2004,457000
6762821193,1720,9,1720,0,3,2011,441000
6762821240,1880,7,1280,600,3,1982,440000
6762821241,3220,8,2610,610,4,2006,440000
6762821474,1778,7,1778,0,3,1999,435000
6762821578,3172,8,3172,0,4,2014,432500
6762822015,2320,8,2320,0,4,2004,423000
6762822163,2750,9,2750,0,4,2005,419900
6762822482,1020,7,1020,0,3,1951,410000
6762822552,1480,6,740,740,2,1925,409000
6762822700,1690,8,1150,540,3,2014,404763
6762822829,2510,7,1710,800,5,1929,400000
6762823808,1630,7,1630,0,3,1950,376500
6762824332,1740,7,1040,700,3,1954,364500
6762824427,780,6,780,0,2,1920,360000
6762825067,1720,8,1320,400,3,1985,348000
6762825112,2690,8,2690,0,4,1998,346290
6762825156,1360,8,1360,0,3,2007,345000
6762825301,1750,8,1750,0,3,1977,341000
6762825509,1590,8,1590,0,4,2001,337000
6762825580,1380,7,1380,0,3,1965,335000
6762825662,880,7,880,0,2,1939,334550
6762825734,1660,7,1660,0,3,1972,331292
6762825932,1990,8,1400,590,4,1978,328000
6762826020,2230,8,2230,0,4,1994,325000
6762826269,2300,8,1770,530,3,1942,320000
6762826485,1010,7,1010,0,2,1981,315000
6762826486,1260,8,1260,0,3,1999,315000
6762826574,1860,7,1860,0,2,2003,314950
6762826698,1560,7,1560,0,3,1974,310000
6762826797,1280,6,920,360,3,1959,309000
6762826810,1600,7,1600,0,3,1990,308550
6762826867,1160,7,1160,0,3,1969,306000
6762826906,2230,8,2230,0,4,2003,305000
6762826907,1260,8,1260,0,3,2009,305000
6762826908,2320,7,2320,0,4,2007,305000
6762827102,2093,7,2093,0,5,1963,300000
6762827369,1810,8,1810,0,3,1991,295000
6762827774,1760,7,780,980,4,1925,285000
6762827841,2080,7,1550,530,3,2003,284000
6762827942,2230,7,1400,830,4,1968,280000
6762828125,1850,8,1850,0,4,1998,277000
6762828191,1640,7,1640,0,3,1996,275000
6762828192,2217,7,2217,0,3,2009,275000
6762828556,1650,7,1650,0,3,1986,267500
6762829355,1260,7,810,450,3,2011,249000
6762829755,980,7,980,0,3,1951,237502
6762830088,2380,6,1380,1000,3,1918,227000
6762830556,2340,7,2340,0,5,1957,210000
6762830629,1070,7,1070,0,3,1994,208000
6762830695,2200,6,1100,1100,4,1944,205000
6762830794,1290,7,1290,0,3,1994,200000
6762830947,1070,7,1070,0,3,1971,194000
6762831158,1790,6,1410,380,4,1900,179000
6762831284,1200,6,1200,0,3,1977,168000
6762831415,902,7,902,0,3,1965,152000
6762831478,1090,7,1090,0,3,1955,140000
6762810370,3940,10,3230,710,5,2008,1700000
6762810669,3230,10,1640,1590,4,2000,1390000
6762810831,4080,12,3210,870,4,1998,1290000
6762810848,4390,11,2430,1960,4,1994,1280000
6762811044,3020,9,3020,0,4,1976,1190000
6762811045,3380,10,2800,580,3,2008,1190000
6762811092,3860,10,2940,920,4,1985,1160000
6762811115,4540,11,4200,340,4,1998,1150000
6762811194,7350,11,4750,2600,5,2001,1110000
6762811443,2600,8,2600,0,4,1965,1020000
6762811461,2480,9,1820,660,4,1967,1010000
6762811558,2550,8,2050,500,3,1940,990000
6762811629,3240,9,3240,0,4,1978,975000
6762812824,2590,8,2590,0,3,1991,815000
6762813072,3230,8,2000,1230,4,1973,795000
6762813114,2560,8,2560,0,2,2004,790000
6762813224,3140,10,3140,0,4,1994,780000
6762813297,3540,9,3540,0,5,1970,775000
6762814160,1760,7,1160,600,3,1927,715000
6762815780,1600,7,1600,0,3,1955,625000
6762815958,2530,7,1210,1320,4,1958,618000
6762816001,2120,8,2120,0,4,2004,615000
6762816309,3010,9,3010,0,4,2000,600000
6762816453,2340,9,2340,0,4,2004,597000
6762816475,1560,7,1560,0,3,1907,595000
6762817130,2340,8,2340,0,4,1989,569500
6762818131,1580,7,1390,190,4,1945,535000
6762818132,980,7,830,150,2,1950,535000
6762818603,1210,8,1210,0,3,2014,520000
6762818709,1640,7,910,730,2,1925,516000
6762819738,1350,7,1180,170,2,2000,482000
6762819855,1510,7,1510,0,3,1928,479200
6762819956,1260,7,1260,0,3,1954,475000
6762820386,2010,8,2010,0,3,1998,463000
6762820560,1570,7,1570,0,3,1972,458000
6762820731,1830,6,1830,0,5,1948,452000
6762820732,1250,7,1250,0,3,1955,452000
6762820806,1450,7,1450,0,3,1919,450000
6762821014,1370,7,1230,140,3,1944,447000
6762821072,1800,8,1270,530,3,1979,445000
6762821161,1800,7,1200,600,3,1957,442500
6762821316,2340,8,2340,0,3,2013,439990
6762821589,1840,8,1310,530,3,1976,432100
6762821867,980,7,980,0,3,1926,425000
6762822181,1500,7,1500,0,3,1958,419000
6762822483,1750,7,1750,0,3,1966,410000
6762823083,2120,7,2120,0,4,1983,396400
6762823482,2090,7,1350,740,4,1994,385000
6762823483,1900,8,1560,340,3,1999,385000
6762823553,1430,8,1140,290,3,2011,384000
6762823818,1480,6,1100,380,3,1920,375950
6762823857,2190,7,1250,940,4,1959,375000
6762823858,1960,7,1260,700,3,1963,375000
6762824428,3200,9,3200,0,4,2007,360000
6762824565,1250,7,1250,0,3,1969,358000
6762824654,960,6,960,0,2,1916,355000
6762825157,2080,7,1040,1040,5,1950,345000
6762825332,2160,7,2160,0,4,2003,340000
6762825333,2170,7,2170,0,3,1995,340000
6762825581,1570,7,1300,270,3,1953,335000
6762825953,1440,6,1440,0,2,1942,327200
6762826699,2010,8,2010,0,3,1953,310000
6762827103,1960,7,1750,210,3,2003,300000
6762827342,1330,7,1000,330,3,1981,295500
6762827730,1170,7,1170,0,2,1913,286000
6762828193,1250,7,1000,250,3,1952,275000
6762828194,930,6,930,0,2,1923,275000
6762828325,1540,7,1540,0,3,1998,272500
6762828524,1820,7,1120,700,4,1959,268500
6762828627,1380,7,1380,0,3,1955,265000
6762828982,1670,7,1670,0,3,2014,256703
6762830795,1070,7,1070,0,4,1944,200000
6762831085,1040,6,1040,0,3,1959,184900
6762831411,1020,6,1020,0,1,1937,152275
6762831434,1320,7,1320,0,3,1979,150000
6762810264,3680,9,3680,0,4,1946,1900000
6762810411,3190,9,1940,1250,4,1949,1650000
6762810784,3270,9,2180,1090,5,2011,1310000
6762810863,3820,10,3820,0,4,2014,1270000
6762810880,2880,10,2880,0,4,2008,1260000
6762810949,3410,10,3410,0,4,1962,1230000
6762811116,4370,11,4370,0,4,2001,1150000
6762811994,1980,9,1980,0,4,2009,912000
6762812256,4720,11,3210,1510,5,2005,875000
6762812476,2450,8,1340,1110,3,1940,850000
6762813073,2920,10,2920,0,4,1995,795000
6762813298,3080,9,3080,0,4,2003,775000
6762813694,1800,8,1000,800,3,1941,749950
6762814001,2440,7,1640,800,4,1941,725000
6762814002,1880,7,1380,500,3,1967,725000
6762814234,2090,7,2090,0,4,1967,710000
6762814813,1780,8,1540,240,3,1989,675000
6762815257,2860,8,2860,0,4,2004,650000
6762815258,1280,7,1280,0,2,1965,650000
6762815356,3410,10,2450,960,3,1973,649000
6762815479,1560,8,1560,0,3,2006,640000
6762816095,2910,10,2910,0,3,1993,610000
6762816619,2320,8,2320,0,3,2003,589000
6762817022,2250,8,2250,0,4,1991,572650
6762817446,1810,7,1810,0,3,1957,555700
6762818016,2960,9,2960,0,4,1990,539950
6762818813,2270,7,1150,1120,5,1965,513000
6762819359,1340,7,1340,0,3,1984,495000
6762819484,2010,8,2010,0,3,1987,490000
6762819641,1870,7,1300,570,3,1962,485000
6762819784,1590,8,1060,530,3,2010,480000
6762819887,2260,8,1760,500,3,2000,477590
6762820132,2220,8,2220,0,3,1987,470000
6762820452,1400,7,1400,0,3,1977,460000
6762820568,1500,8,1500,0,3,1996,457500
6762820807,1980,7,1430,550,4,1973,450000
6762820808,1530,8,1050,480,3,2007,450000
6762821038,1940,7,970,970,4,1951,446000
6762821073,1120,7,870,250,3,1916,445000
6762821376,1520,8,1180,340,3,2006,438000
6762822221,1330,6,850,480,2,1910,417500
6762822297,1300,7,1300,0,3,1958,415000
6762822714,2050,8,1690,360,4,1986,403900
6762823119,1890,7,1890,0,3,1994,395000
6762823193,1450,7,1450,0,4,1951,393000
6762823265,2480,8,1500,980,3,1994,390000
6762823611,1680,6,940,740,3,1996,381000
6762823645,2010,6,2010,0,3,1929,380000
6762823859,2100,8,1440,660,3,1962,375000
6762824069,1600,7,1280,320,3,1987,370000
6762824350,820,6,820,0,2,1925,363000
6762824429,1630,7,1630,0,3,1959,360000
6762824430,1233,7,963,270,2,2007,360000
6762825011,2390,7,2390,0,3,2002,349950
6762825334,1460,7,1460,0,3,1957,340000
6762825969,2060,8,2060,0,3,2014,326989
6762826021,1950,7,1330,620,4,1963,325000
6762826022,1410,7,1410,0,3,1954,325000
6762826362,2475,7,2475,0,4,2014,319900
6762826400,2820,7,1410,1410,5,1967,318000
6762826441,730,6,730,0,2,1927,316000
6762826909,1830,8,1830,0,3,1989,305000
6762827104,2080,8,2080,0,4,1998,300000
6762827460,1420,7,1420,0,3,1974,293000
6762827541,2810,8,2010,800,6,1958,290000
6762827542,2000,7,2000,0,3,1993,290000
6762827673,1660,7,1040,620,3,1978,288000
6762828195,1900,7,1200,700,3,1968,275000
6762828628,1840,7,1270,570,3,1980,265000
6762828815,820,6,820,0,2,1918,260000
6762829968,1520,7,1520,0,4,1960,230000
6762829969,1140,8,1140,0,3,2014,230000
6762829970,1040,9,900,140,3,2015,230000
6762830140,2510,8,2510,0,3,1988,225000
6762830212,1480,7,1480,0,3,1957,224000
6762830225,1310,6,1310,0,3,1951,223000
6762830378,1000,7,1000,0,3,1959,217000
6762830768,1010,5,1010,0,3,1961,201000
6762830842,1510,6,1510,0,3,1938,199950
6762831099,1280,6,1280,0,3,1985,183000
6762831113,1560,7,1560,0,2,1949,181000
6762831235,970,6,720,250,3,1943,172000
6762831270,790,6,790,0,2,1944,169500
6762810109,4190,9,3490,700,4,1928,2550000
6762810232,4360,10,4360,0,4,2007,1980000
6762810453,4270,10,3210,1060,5,2014,1600000
6762810719,2070,7,1590,480,3,1946,1350000
6762810785,2770,9,2770,0,5,2002,1310000
6762810950,3420,11,3420,0,3,1990,1230000
6762811164,2660,9,2660,0,4,1999,1130000
6762811706,2820,9,1770,1050,4,1952,960000
6762811995,2979,11,2979,0,3,1993,912000
6762812534,2720,10,2070,650,4,2014,846000
6762812872,3010,9,3010,0,4,1996,810000
6762813020,3110,9,3110,0,4,2014,799990
6762813753,3140,8,2200,940,4,2004,744000
6762813977,2790,9,2790,0,4,1997,725500
6762814003,2190,7,1450,740,4,1962,725000
6762814079,1840,8,1340,500,2,1957,720000
6762814130,2840,10,2840,0,3,2006,717550
6762814296,2780,8,2780,0,4,2001,705000
6762814449,3340,10,3340,0,5,2002,699000
6762814814,2040,8,1610,430,4,1968,675000
6762814874,1520,8,1400,120,3,1908,672600
6762814906,2570,9,2570,0,4,1999,670000
6762815576,2460,8,2460,0,4,1952,635000
6762816197,1850,8,1370,480,3,1973,605000
6762816476,2660,9,2660,0,3,1991,595000
6762816507,2380,8,2380,0,4,1977,594950
6762816563,2550,8,1980,570,3,1967,590000
6762817137,2400,8,1590,810,4,1956,569000
6762817341,2270,8,1880,390,3,1996,560000
6762817752,1580,7,1580,0,3,1958,549800
6762817764,1710,8,1710,0,5,1974,549000
6762819238,1870,7,1120,750,3,1955,499950
6762819360,2350,8,2350,0,4,1980,495000
6762819435,1540,8,1200,340,3,1984,492450
6762819715,1670,8,1670,0,3,2001,483500
6762820362,1750,7,1610,140,4,1947,464500
6762820626,1320,9,1320,0,3,2015,455000
6762820702,1510,8,1330,180,3,2011,453000
6762821074,2630,7,1830,800,4,1944,445000
6762821177,4168,10,3222,946,4,2007,442000
6762821410,1130,8,1030,100,3,2004,437000
6762821475,1440,8,1440,0,3,2005,435000
6762821476,1740,8,1240,500,3,1958,435000
6762821611,1370,8,1370,0,2,2005,431500
6762821749,2100,6,1400,700,4,1916,429000
6762822008,1940,8,1940,0,3,1965,423800
6762822244,1100,7,1100,0,3,1965,416500
6762822298,1160,7,1160,0,4,1989,415000
6762822299,1610,8,1610,0,3,2010,415000
6762822407,1530,6,1530,0,3,1942,412500
6762822484,2000,8,1320,680,3,1972,410000
6762822567,1470,8,1470,0,3,2006,408000
6762822645,1590,7,1100,490,3,1976,405000
6762822646,1970,7,1370,600,4,1962,405000
6762822647,1500,7,1500,0,3,1994,405000
6762822648,1500,7,1500,0,3,2005,405000
6762822756,2430,8,1430,1000,4,1953,402000
6762822830,2120,7,2120,0,3,2006,400000
6762822831,3350,7,2140,1210,4,1980,400000
6762823484,2040,7,1380,660,4,1954,385000
6762823756,2260,8,2260,0,4,2011,379000
6762823860,900,7,900,0,2,1947,375000
6762824506,3010,8,3010,0,4,2003,359950
6762824536,1320,7,1080,240,3,2003,359000
6762824732,1260,7,1260,0,3,1968,354000
6762824874,860,7,860,0,3,1973,350000
6762825547,2240,8,1700,540,5,1968,335500
6762826023,1080,7,1080,0,2,1954,325000
6762826270,1100,7,1100,0,4,1954,320000
6762826442,2600,7,2600,0,5,2005,316000
6762827260,1040,6,1040,0,2,1950,299000
6762827620,1500,7,1200,300,4,1956,289950
6762827731,1770,7,1090,680,3,1954,286000
6762827775,990,7,990,0,2,1998,285000
6762828196,3020,7,3020,0,3,2003,275000
6762829473,1370,7,1370,0,3,1955,245000
6762829971,1710,7,1030,680,3,1977,230000
6762830986,1100,8,1100,0,2,2006,190000
6762830987,1350,6,1350,0,3,1912,190000
6762831168,1100,7,1100,0,3,1955,178000
6762831344,1610,7,1610,0,3,1964,160000
6762810897,3160,9,2360,800,4,1965,1250000
6762817201,1700,7,1700,0,3,1966,565000
6762825158,860,7,860,0,2,1940,345000
6762829401,1580,7,1580,0,3,2003,247800
6762831319,1000,7,990,10,2,2004,163800
6762817961,1360,7,1360,0,4,1951,540000
6762810023,9200,13,6200,3000,5,2001,5570000
6762810644,4040,9,2020,2020,4,1951,1400000
6762810929,5790,10,4430,1360,5,2014,1240000
6762811486,4670,11,4670,0,5,1998,1000000
6762811811,3160,8,2310,850,4,1939,942000
6762812106,2890,8,1990,900,4,1911,898500
6762812355,3480,9,3480,0,5,2014,864327
6762812575,2480,9,1630,850,4,1966,840000
6762812625,3270,10,3270,0,4,2001,835000
6762812639,3360,9,3360,0,5,2014,834995
6762812688,3360,9,3360,0,5,2014,829995
6762812825,3500,10,3500,0,5,1996,815000
6762812898,3660,9,2760,900,4,2014,809950
6762812907,3480,9,3480,0,4,2003,808000
6762813100,3250,10,3250,0,4,1994,791500
6762813150,1580,7,1080,500,4,1963,787500
6762813209,1760,8,1760,0,5,1902,780500
6762813299,3010,10,3010,0,3,1998,775000
6762813403,2660,9,1830,830,3,1988,768000
6762813488,2500,8,2500,0,4,1979,760000
6762813622,2850,9,2850,0,5,1951,750000
6762814557,3210,8,3210,0,4,1985,690000
6762814704,1820,7,1090,730,1,1910,680000
6762814705,2920,8,1710,1210,3,1956,680000
6762814882,1600,8,1600,0,2,1940,672324
6762815950,1650,8,1650,0,3,2014,619000
6762815973,3580,9,3240,340,3,1992,616500
6762816158,3000,8,3000,0,4,1992,607500
6762816198,1820,7,990,830,4,1941,605000
6762816753,1800,7,1800,0,3,1955,583000
6762816804,2150,8,2150,0,4,2001,580000
6762816805,1480,8,1480,0,3,2014,580000
6762816865,1590,8,1280,310,3,1948,579000
6762817046,1920,8,1920,0,3,2005,571000
6762817067,2510,8,2510,0,5,1969,570000
6762817439,2750,9,2750,0,3,1994,556000
6762817520,850,7,850,0,2,1922,553500
6762817609,2920,9,2920,0,3,1990,550000
6762818053,2500,8,2500,0,3,2000,538500
6762818437,2310,9,2310,0,4,2003,525000
6762819107,1570,7,1190,380,3,1983,500000
6762819588,1940,8,1940,0,3,2001,488000
6762819957,1320,8,1320,0,3,2006,475000
6762820079,2010,8,1390,620,3,2014,472217
6762820174,2350,8,2350,0,4,2014,469995
6762820756,2050,8,2050,0,3,2005,451000
6762820809,1610,8,1610,0,3,1978,450000
6762820810,1180,7,1180,0,2,1955,450000
6762821139,1330,7,930,400,2,1919,443500
6762821178,1360,7,1010,350,4,1955,442000
6762821242,2800,9,2800,0,4,2001,440000
6762821477,2370,7,2370,0,3,2004,435000
6762822001,1430,7,1430,0,3,1972,424000
6762822231,2500,7,1730,770,3,1941,417000
6762822300,1460,6,880,580,2,1914,415000
6762822832,1270,7,910,360,2,1949,400000
6762822833,1860,9,1860,0,3,2002,400000
6762823266,1850,7,1850,0,3,1965,390000
6762823454,1060,6,1060,0,3,1949,385100
6762823485,1650,7,1260,390,3,1969,385000
6762823486,1220,6,620,600,3,1905,385000
6762823545,1600,8,1600,0,3,2005,384500
6762823861,1900,7,1170,730,6,1959,375000
6762823862,980,7,980,0,3,1967,375000
6762824212,1280,7,1280,0,4,1958,367400
6762824366,960,6,960,0,3,1916,362500
6762824431,1560,7,1560,0,3,1980,360000
6762825418,2060,8,2060,0,3,2014,339989
6762825582,2010,8,1500,510,3,1967,335000
6762825775,1030,7,1030,0,3,1953,330000
6762825776,1460,7,1460,0,3,1985,330000
6762825933,1850,8,1850,0,4,2009,328000
6762826024,1060,6,1060,0,2,1946,325000
6762826025,1780,7,1210,570,3,1979,325000
6762826026,2800,7,2800,0,4,2011,325000
6762826162,2060,8,2060,0,3,2014,324747
6762826487,1970,7,1270,700,3,1964,315000
6762826830,1820,8,1820,0,3,2014,307635
6762827543,1710,7,1060,650,3,1967,290000
6762827746,1040,7,1040,0,3,1953,285650
6762828278,1840,8,1840,0,3,1989,274950
6762828494,800,7,800,0,2,1999,269500
6762828629,2050,7,1240,810,3,1979,265000
6762828788,810,7,810,0,2,1928,260600
6762828816,570,6,570,0,2,1936,260000
6762829024,1710,7,1710,0,3,1972,255000
6762830048,1180,6,1180,0,1,1948,229500
6762830104,1300,7,900,400,3,1976,226500
6762830557,1020,5,1020,0,3,1900,210000
6762830796,830,6,830,0,2,1954,200000
6762831548,940,5,940,0,2,1947,121800
6762810157,3280,10,2180,1100,4,1911,2300000
6762810587,3100,9,2090,1010,4,1923,1450000
6762810645,3850,9,2290,1560,5,1964,1400000
6762810720,4100,9,4100,0,4,2014,1350000
6762810807,3870,10,3870,0,5,2014,1300000
6762810970,3200,9,3200,0,4,1962,1220000
6762811487,3600,9,1940,1660,6,1977,1000000
6762811488,1780,9,1780,0,4,1967,1000000
6762811535,4280,10,4280,0,5,2014,995500
6762811671,2450,8,2200,250,4,1919,969000
6762811707,4510,10,2820,1690,5,2003,960000
6762811759,4040,10,3030,1010,3,1986,950000
6762811903,2670,8,1940,730,4,1929,925000
6762812004,4190,9,2040,2150,4,1965,910000
6762812155,3180,10,3180,0,4,2005,890000
6762812257,2530,8,2530,0,5,1976,875000
6762812603,2620,9,2620,0,4,1974,838400
6762812813,2600,8,2600,0,4,1979,817000
6762812925,3020,9,3020,0,4,2009,805000
6762813166,2990,9,2990,0,4,2003,785000
6762813225,3900,10,3900,0,4,1991,780000
6762813300,2600,9,2600,0,5,2014,775000
6762813489,1170,7,1170,0,3,1955,760000
6762813490,2920,9,2920,0,4,2004,760000
6762813573,2160,8,1660,500,4,1974,753000
6762813623,4610,9,4610,0,3,1984,750000
6762814112,2120,9,2120,0,3,1984,719000
6762814558,1760,8,1760,0,4,1954,690000
6762814750,2440,9,1980,460,3,2000,679900
6762815065,2680,9,2680,0,3,1993,660000
6762815259,1840,8,1140,700,3,1914,650000
6762815670,1910,8,1910,0,4,2014,630000
6762816238,2580,8,1290,1290,6,1987,604000
6762816765,2380,8,2380,0,3,1995,582000
6762816806,2150,8,2150,0,3,2003,580000
6762816807,3030,8,2150,880,5,2014,580000
6762816945,2070,8,2070,0,3,1999,575000
6762817202,1540,7,1490,50,3,1930,565000
6762817414,3220,9,2420,800,4,2000,558000
6762817511,1870,8,1870,0,2,2004,554000
6762817532,2320,8,1370,950,5,1986,552500
6762817533,2020,7,1520,500,3,1929,552500
6762817962,1380,8,1160,220,3,2008,540000
6762818133,1890,7,1890,0,4,2005,535000
6762818191,2130,7,1330,800,4,1965,534000
6762818438,2500,8,1380,1120,4,1978,525000
6762818604,1410,7,1410,0,3,1902,520000
6762818972,2100,8,2100,0,3,1990,506000
6762819108,1220,7,1060,160,3,1927,500000
6762819361,1830,8,1830,0,3,1997,495000
6762819642,2590,8,1590,1000,3,1971,485000
6762819842,2010,8,1390,620,3,2014,479990
6762820453,1370,7,970,400,3,1972,460000
6762820574,2820,9,2820,0,4,2013,457000
6762820680,2490,7,1400,1090,4,1979,454800
6762820733,2600,8,1490,1110,3,1956,452000
6762820811,1680,8,1680,0,3,1967,450000
6762821075,1960,7,1960,0,4,1979,445000
6762821076,2230,7,2230,0,3,2005,445000
6762821411,1980,7,1290,690,3,1959,437000
6762821664,1690,7,1690,0,3,1954,430000
6762821868,1670,7,1170,500,3,1977,425000
6762821869,2070,7,2070,0,4,2007,425000
6762821870,1900,8,1900,0,4,2014,425000
6762822251,1980,7,990,990,4,1961,416000
6762822301,2000,8,2000,0,3,1959,415000
6762822394,1690,8,1150,540,3,2014,413565
6762822757,2160,7,1220,940,5,1955,402000
6762822834,2010,7,1450,560,2,1922,400000
6762822948,1360,8,1094,266,3,2006,399950
6762823120,960,7,960,0,2,1951,395000
6762823863,1190,7,1190,0,3,1948,375000
6762824070,2190,7,1110,1080,4,1966,370000
6762824261,1640,7,1290,350,3,1958,365000
6762824432,1170,6,1170,0,3,1917,360000
6762824733,1060,7,1060,0,3,1981,354000
6762825068,2060,9,2060,0,3,1989,348000
6762825647,1650,7,1650,0,3,1998,334999
6762825777,1550,6,1550,0,4,1967,330000
6762826363,2475,7,2475,0,4,2014,319900
6762826424,1530,8,1530,0,3,1977,317000
6762826700,1490,6,1490,0,3,1967,310000
6762826701,1960,7,1750,210,3,2003,310000
6762826790,1340,7,1340,0,3,1968,309500
6762827105,2020,7,1250,770,3,1963,300000
6762827261,740,7,740,0,1,1923,299000
6762827440,2930,8,2930,0,4,1965,294000
6762828058,1400,7,1060,340,3,1955,279000
6762828290,1680,7,1400,280,5,1929,274000
6762828336,1380,7,1380,0,3,1963,272000
6762828488,1750,7,1750,0,5,1966,269900
6762828503,1210,7,1210,0,3,2003,269000
6762828786,1560,7,1260,300,3,1966,260750
6762829228,780,7,780,0,1,1922,250000
6762829229,990,6,990,0,3,1949,250000
6762829474,1850,7,1180,670,3,1970,245000
6762829591,1580,7,790,790,3,1944,242000
6762829633,2210,7,1310,900,6,1959,240000
6762829713,1570,7,1200,370,4,1960,239900
6762829765,1710,8,1260,450,3,1968,237000
6762829816,870,6,870,0,2,1949,235000
6762829817,1330,6,1330,0,3,1967,235000
6762830274,2020,7,1010,1010,4,1968,220000
6762830275,1530,6,1530,0,4,1938,220000
6762830558,1190,6,1190,0,2,1939,210000
6762831061,1080,7,1080,0,3,1968,185000
6762831195,1050,6,1050,0,2,1975,175000
6762831275,1570,6,1570,0,3,1931,169000
6762831334,1700,7,850,850,4,1954,161000
6762810169,3890,12,2890,1000,3,2006,2250000
6762810279,4390,9,3170,1220,5,2013,1880000
6762810898,5000,10,5000,0,5,2000,1250000
6762811760,2620,9,2620,0,4,1965,950000
6762811904,3300,10,3300,0,4,1991,925000
6762812127,2500,10,1910,590,3,1993,895000
6762812417,3420,9,2620,800,5,2003,855000
6762813422,2440,8,1320,1120,3,1945,765000
6762814113,1833,9,1833,0,3,1998,719000
6762814364,3100,10,3100,0,4,1994,700000
6762814877,1860,8,1020,840,2,1956,672500
6762814907,3020,8,1540,1480,4,1977,670000
6762815154,2540,8,1320,1220,4,1948,655000
6762815155,3160,8,1580,1580,4,1962,655000
6762815221,2340,8,1290,1050,4,1953,650500
6762815260,2500,9,1510,990,3,2013,650000
6762815372,2620,9,2620,0,4,2001,648000
6762815480,2100,7,1500,600,4,1911,640000
6762815671,1610,8,1220,390,3,2005,630000
6762816175,2390,8,1740,650,4,1979,606000
6762816537,2310,8,1790,520,4,1989,592100
6762816946,2510,9,2510,0,4,1987,575000
6762817461,2480,8,2480,0,3,1989,555000
6762817610,2230,7,1480,750,4,1960,550000
6762817611,1630,8,1630,0,3,1954,550000
6762817838,2040,8,2040,0,4,1988,545000
6762817963,2370,7,1640,730,3,1959,540000
6762818210,2490,8,2040,450,4,1976,532500
6762818268,1264,8,1264,0,3,2003,530000
6762818347,1530,7,990,540,3,1907,529000
6762818439,2300,7,1350,950,3,1979,525000
6762818863,2510,7,1260,1250,5,1975,510000
6762818921,1880,8,1880,0,3,1993,509950
6762818927,2060,7,1320,740,5,1961,509500
6762819785,1600,8,1600,0,3,1963,480000
6762820812,1290,8,1290,0,3,2001,450000
6762821478,1400,6,700,700,3,1917,435000
6762821479,1610,7,1260,350,3,1988,435000
6762821597,2820,8,2820,0,4,1976,432000
6762821629,2710,8,2710,0,5,2014,430760
6762821665,2420,7,2420,0,2,2007,430000
6762821666,1550,8,1550,0,3,2006,430000
6762821742,2930,8,1730,1200,6,1965,429300
6762821871,2390,7,2390,0,4,2002,425000
6762822302,2520,7,1510,1010,4,1909,415000
6762822702,800,7,800,0,2,1938,404500
6762823267,1910,8,1910,0,4,1971,390000
6762823378,1520,7,1520,0,4,1971,389000
6762823487,1800,6,1800,0,4,1912,385000
6762823594,1650,8,1650,0,2,2008,382000
6762823767,1867,9,1867,0,4,2013,378950
6762823864,1800,7,1200,600,4,1960,375000
6762823979,1390,7,1390,0,3,1973,374150
6762824205,2980,7,1680,1300,5,1940,367500
6762824262,1270,7,1270,0,2,1982,365000
6762824391,1950,8,1950,0,3,1999,361000
6762824875,1430,7,1150,280,2,1944,350000
6762824876,1370,6,1370,0,3,1949,350000
6762825012,1570,8,1310,260,2,2006,349950
6762825278,1640,8,1640,0,3,2010,342000
6762825907,1140,6,1140,0,3,1911,329000
6762825908,1980,8,1360,620,3,1977,329000
6762825958,1840,5,1840,0,4,1933,327000
6762826671,2030,8,2030,0,4,2004,310950
6762826991,950,7,850,100,2,2003,304000
6762827106,1910,7,1910,0,4,2005,300000
6762827107,1260,8,1260,0,3,1999,300000
6762827108,2120,6,1440,680,2,1924,300000
6762827109,1880,7,1880,0,3,2007,300000
6762827110,1330,7,1330,0,3,2002,300000
6762827328,1280,7,1280,0,3,1948,296500
6762827544,1120,6,1120,0,2,1976,290000
6762827776,1940,7,1940,0,3,1990,285000
6762828504,1594,7,1088,506,4,1975,269000
6762828573,1760,8,1760,0,3,1986,267000
6762828817,1750,8,1750,0,3,1968,260000
6762828960,1900,7,1360,540,4,1922,257000
6762829450,790,6,790,0,2,1950,245500
6762829475,2210,7,1540,670,3,1967,245000
6762829634,1670,7,1670,0,2,1941,240000
6762829818,1760,7,1760,0,4,1951,235000
6762830522,1410,7,1410,0,3,1981,211000
6762830797,1000,6,1000,0,2,1949,200000
6762831062,1380,7,1190,190,4,1928,185000
6762831176,770,6,770,0,2,1969,176000
6762810588,3200,9,2600,600,4,1997,1450000
6762810951,2020,9,1760,260,4,1941,1230000
6762811010,4610,11,3310,1300,5,2006,1200000
6762811254,2560,8,1660,900,3,1927,1090000
6762813041,2500,8,2500,0,5,1959,799000
6762813301,3390,10,3390,0,4,2008,775000
6762813580,2280,8,2280,0,2,2005,752500
6762814161,2460,8,2460,0,4,1968,715000
6762814622,2290,8,2290,0,3,1972,685900
6762815261,2100,8,2100,0,4,2001,650000
6762815546,1980,7,1380,600,3,1958,637000
6762815621,2180,8,1410,770,3,1930,634950
6762815672,2330,7,1310,1020,5,1956,630000
6762815898,1660,7,1100,560,3,1929,620000
6762816064,2680,7,1680,1000,4,1928,612000
6762816437,2520,8,2520,0,4,2005,598500
6762818204,1550,7,1550,0,4,1919,533000
6762818440,1170,6,1170,0,4,1960,525000
6762819109,1560,8,1560,0,3,1961,500000
6762819616,1340,8,1190,150,2,2006,485500
6762819786,1710,7,1130,580,3,1979,480000
6762820370,1690,7,1690,0,3,2003,464000
6762820813,1960,8,1960,0,3,1977,450000
6762820814,2500,8,1590,910,4,1978,450000
6762820815,1520,6,1520,0,4,1949,450000
6762820816,1770,8,1430,340,3,2003,450000
6762821480,1050,6,930,120,3,1920,435000
6762821563,2075,8,2075,0,3,2002,433200
6762821569,1920,7,1300,620,3,1984,433000
6762822075,1940,7,1090,850,4,1955,420000
6762822076,1470,8,1180,290,3,2007,420000
6762822153,2260,8,2260,0,4,1996,419950
6762822408,1630,7,1100,530,4,1977,412500
6762822485,1440,7,1180,260,3,1979,410000
6762823046,2220,7,1320,900,4,1918,397500
6762823268,1690,7,1310,380,3,1991,390000
6762823865,2320,7,1480,840,3,1987,375000
6762823866,1450,6,1450,0,4,1947,375000
6762824071,820,7,820,0,2,1949,370000
6762824163,2420,8,2420,0,4,2005,369000
6762824525,2170,8,2170,0,5,2014,359800
6762824655,1370,8,1080,290,2,2009,355000
6762824877,1390,7,910,480,3,1926,350000
6762825414,1740,6,870,870,4,1954,339999
6762825583,1900,7,1900,0,3,1962,335000
6762826027,1870,7,1870,0,4,1956,325000
6762826271,2640,8,1620,1020,4,1967,320000
6762826377,1930,8,1930,0,4,1995,319000
6762826597,1440,7,1440,0,3,1983,313500
6762826659,860,6,860,0,2,1903,311000
6762826660,2690,7,2690,0,4,2007,311000
6762826702,1140,7,1140,0,3,1988,310000
6762827484,880,6,880,0,2,1904,292000
6762828401,1900,7,1200,700,4,1956,270000
6762828557,1747,6,1747,0,2,1948,267500
6762829139,900,6,900,0,2,1961,252500
6762829230,1700,7,1120,580,3,1960,250000
6762829939,930,6,930,0,2,1912,230950
6762830559,840,6,840,0,2,1948,210000
6762830883,790,7,790,0,2,1951,198000
6762830916,1580,7,1580,0,3,1979,195000
6762831125,1010,6,1010,0,3,1955,180000
6762810158,5310,10,3650,1660,7,2013,2300000
6762810326,3230,10,3230,0,3,2005,1780000
6762810371,4330,11,3230,1100,4,1988,1700000
6762810475,4670,12,4670,0,4,1988,1580000
6762810755,4010,12,4010,0,4,1990,1330000
6762810849,3650,8,2530,1120,9,1915,1280000
6762811397,2910,10,2910,0,4,2014,1040000
6762811444,4690,10,4030,660,4,2007,1020000
6762811549,3470,10,3470,0,4,1963,994000
6762812064,2620,8,1770,850,3,1980,900000
6762812300,3400,8,2320,1080,5,1900,870000
6762812849,2810,9,1810,1000,4,1978,812500
6762813074,3100,10,3100,0,4,1998,795000
6762814004,1940,7,1940,0,3,1906,725000
6762814005,2880,8,2480,400,4,1965,725000
6762814051,3510,10,3510,0,4,2001,723000
6762814162,1610,6,900,710,3,1956,715000
6762814984,1590,9,1060,530,3,2014,665000
6762815577,1780,8,1210,570,3,1980,635000
6762815673,2290,8,2290,0,4,1977,630000
6762816002,2270,8,2270,0,4,1959,615000
6762816096,2260,9,1660,600,3,1986,610000
6762816564,2210,8,2210,0,3,1988,590000
6762817393,1660,9,1660,0,3,2014,559950
6762817612,1830,7,1150,680,3,1928,550000
6762817839,1820,7,1130,690,6,1954,545000
6762818201,910,5,910,0,2,1953,533050
6762818357,2050,8,1540,510,4,1988,528000
6762818605,1890,7,1890,0,4,2003,520000
6762818831,2550,9,2550,0,4,1996,512000
6762819110,2590,9,2590,0,4,1993,500000
6762819239,3180,9,3180,0,5,1978,499950
6762819271,3010,8,2410,600,3,1978,499000
6762819362,2630,8,1690,940,5,1976,495000
6762819589,1000,7,1000,0,2,1942,488000
6762820513,2430,8,1780,650,4,1974,459950
6762821077,2470,7,2470,0,3,2005,445000
6762821078,1860,7,1240,620,3,1977,445000
6762821179,1980,8,1980,0,3,1994,442000
6762821872,970,7,770,200,2,1926,425000
6762821985,2760,8,2760,0,5,2013,424950
6762821986,2760,8,2760,0,5,2013,424950
6762822195,1470,7,1470,0,3,1954,418900
6762822579,770,7,770,0,2,1923,407500
6762822649,880,7,880,0,2,1927,405000
6762822776,1400,7,1400,0,2,1949,401000
6762822992,1940,7,1140,800,3,1978,399000
6762823047,1030,7,1030,0,3,1954,397500
6762823048,1430,8,1430,0,3,2005,397500
6762823269,2570,7,1420,1150,4,1988,390000
6762823270,1870,7,1870,0,3,1959,390000
6762823400,2198,8,2198,0,3,2010,388000
6762823795,1350,8,1270,80,3,2006,377500
6762824263,2190,8,2190,0,3,2004,365000
6762824537,2575,8,2575,0,4,2011,359000
6762824749,2050,8,2050,0,4,2014,353500
6762825159,1540,7,1540,0,3,1999,345000
6762825691,2623,8,2623,0,4,2012,333000
6762825778,2600,7,2600,0,5,2005,330000
6762826401,1010,6,1010,0,3,1948,318000
6762827111,1150,7,1150,0,2,1982,300000
6762827262,1200,7,1200,0,3,1955,299000
6762827621,1670,7,1670,0,3,2002,289950
6762827943,1860,7,1860,0,3,1994,280000
6762828291,1940,7,1720,220,4,1966,274000
6762828337,1200,7,1200,0,3,1942,272000
6762828338,1980,8,1980,0,3,1994,272000
6762828402,2630,8,2630,0,5,1968,270000
6762828403,1470,7,1350,120,3,1959,270000
6762828935,2270,8,1330,940,3,1978,258000
6762829476,1700,7,1700,0,4,2000,245000
6762829819,720,6,720,0,2,1940,235000
6762829820,1500,6,1500,0,4,1944,235000
6762830141,1350,7,1350,0,3,1968,225000
6762830322,1010,6,1010,0,2,1907,219950
6762830560,1200,5,1200,0,4,1968,210000
6762830843,700,5,700,0,2,1952,199950
6762831105,1040,6,1040,0,2,1973,182500
6762820176,1760,8,1760,0,3,2008,469950
6762829356,1300,7,1300,0,3,1964,249000
6762814069,1430,7,1430,0,3,1910,720001
6762823780,2150,8,2150,0,3,2004,378000
6762828818,2320,9,2320,0,4,1977,260000
6762810066,4410,11,3430,980,3,2014,3000000
6762810335,6055,12,3555,2500,4,1996,1760000
6762810527,2610,8,2610,0,3,1963,1520000
6762810625,3110,10,2510,600,4,1931,1420000
6762810670,4010,11,4010,0,4,2006,1390000
6762810756,2850,10,2700,150,4,1905,1330000
6762811351,2930,9,2670,260,3,1999,1050000
6762811462,3130,10,3130,0,4,2014,1010000
6762811650,4390,9,3350,1040,5,2005,971000
6762811676,2630,9,2630,0,4,1963,968000
6762811708,2460,7,1230,1230,3,1938,960000
6762811905,2710,7,1890,820,5,1919,925000
6762812147,3170,9,3170,0,5,2014,890776
6762812156,3220,11,3220,0,4,1994,890000
6762812187,1313,8,1313,0,2,1904,885000
6762812301,2910,9,2910,0,5,1968,870000
6762812397,3390,9,3390,0,4,2011,859900
6762812576,3050,8,3050,0,3,2004,840000
6762812601,4280,10,2710,1570,5,1996,839000
6762812982,2570,10,2570,0,4,1993,800000
6762813268,2490,8,2490,0,4,2014,778983
6762813302,4220,8,2600,1620,4,1984,775000
6762813709,3380,8,3380,0,3,1965,749000
6762813855,2350,7,1020,1330,3,1948,735000
6762813885,2160,9,2160,0,3,1989,733000
6762814006,3410,11,3410,0,3,1990,725000
6762814080,2860,9,2860,0,5,2005,720000
6762814433,2070,7,1180,890,4,1941,699950
6762814584,2520,8,2520,0,4,2014,689950
6762814706,1820,7,1320,500,3,1960,680000
6762815481,2460,8,1560,900,4,1965,640000
6762815514,1780,7,890,890,2,1925,639950
6762815524,2010,9,1610,400,3,2014,639000
6762815899,1530,7,1030,500,4,1981,620000
6762816246,2670,8,2670,0,4,1999,603000
6762816310,1810,8,1390,420,4,1977,600000
6762816415,1650,8,1650,0,3,2014,599000
6762816688,2220,8,2220,0,3,1989,585000
6762816947,2770,8,1780,990,2,1983,575000
6762817068,3150,10,3150,0,3,1990,570000
6762817900,2060,8,2060,0,4,1983,543000
6762818027,1650,8,1230,420,3,1976,539900
6762818051,3040,9,3040,0,5,2005,538900
6762818134,1660,7,1260,400,3,1957,535000
6762818211,2160,7,1430,730,3,1979,532500
6762818737,3430,9,3430,0,3,2001,515000
6762818738,2610,8,2610,0,3,2005,515000
6762818840,3361,10,3361,0,5,2006,511000
6762818944,2890,8,1830,1060,6,1976,508000
6762819363,970,7,970,0,2,1905,495000
6762819903,1060,7,1060,0,3,1962,476500
6762819922,1670,8,1670,0,3,2000,475200
6762819958,1550,7,1550,0,3,1926,475000
6762820371,2460,8,1520,940,3,2001,464000
6762820519,2340,8,1510,830,3,1978,459900
6762820627,2720,8,2720,0,3,1986,455000
6762820817,4050,7,4050,0,9,1996,450000
6762820818,1290,6,790,500,3,1929,450000
6762821422,2692,9,2692,0,4,2014,436472
6762821750,2210,8,1820,390,3,1995,429000
6762822077,2700,9,1570,1130,3,1986,420000
6762822078,2300,7,1430,870,3,1965,420000
6762822303,3900,6,3460,440,3,1967,415000
6762822304,2230,7,2230,0,4,2002,415000
6762822758,1640,7,1010,630,4,1968,402000
6762822835,1460,7,1460,0,3,1952,400000
6762822836,2393,8,2393,0,3,2012,400000
6762823018,3000,8,3000,0,4,2003,398950
6762823271,930,6,930,0,2,1911,390000
6762823446,2810,8,2810,0,4,2003,386000
6762823612,1330,7,1330,0,3,1969,381000
6762823749,1730,7,1330,400,3,1991,379260
6762824206,1930,8,1300,630,4,1960,367500
6762824230,1350,7,1350,0,3,1977,366000
6762824656,1590,7,1590,0,3,2000,355000
6762824827,1870,7,1390,480,3,1975,350500
6762824878,1320,6,1320,0,3,1909,350000
6762825031,1580,8,1580,0,3,2011,349900
6762825335,1140,7,1140,0,3,1994,340000
6762825584,2440,8,2440,0,3,1998,335000
6762825664,1700,7,1120,580,3,1961,334500
6762825959,1070,7,1070,0,2,1947,327000
6762826028,1100,7,620,480,2,1980,325000
6762826354,1280,8,1060,220,2,2006,319950
6762826412,2150,7,1360,790,4,1979,317500
6762826589,1870,8,1870,0,4,1992,314000
6762826910,2460,8,2460,0,3,2002,305000
6762827318,1450,7,1450,0,3,1994,297000
6762827370,1440,7,1050,390,3,1979,295000
6762827485,1560,8,1560,0,3,1999,292000
6762827522,1670,7,1670,0,3,1992,290700
6762827545,1076,7,1076,0,2,2006,290000
6762827641,2860,9,1700,1160,3,1985,289275
6762827944,720,6,720,0,2,1951,280000
6762828292,1450,7,1450,0,3,2011,274000
6762828404,1390,7,1390,0,3,1978,270000
6762828472,2060,7,1260,800,4,1968,269950
6762829115,1220,6,1220,0,3,1959,253500
6762829140,770,6,770,0,2,1937,252500
6762829905,1100,7,1100,0,3,1955,233000
6762830056,1370,7,1370,0,3,1942,229000
6762830057,1200,6,1200,0,3,1979,229000
6762830614,1230,7,1020,210,3,2003,209000
6762830677,1490,6,1490,0,3,1963,205950
6762830844,1048,7,1048,0,1,1942,199950
6762831271,1060,6,1060,0,3,1962,169500
6762831479,900,6,900,0,2,1940,140000
6762810053,7000,12,3500,3500,4,1991,3200000
6762810184,5210,10,4940,270,5,1911,2200000
6762810192,4240,10,4240,0,4,2004,2190000
6762810412,4610,11,4610,0,4,2003,1650000
6762811700,3910,10,3910,0,3,1999,961500
6762811800,3140,9,2140,1000,4,1989,946000
6762811906,2710,9,1430,1280,4,1976,925000
6762811976,3210,10,3210,0,4,1998,915000
6762812302,2420,8,2200,220,3,1925,870000
6762812477,1950,8,1430,520,3,1911,850000
6762812602,2400,8,1760,640,4,1958,839000
6762812766,1450,7,1450,0,2,1924,822500
6762812873,4170,9,2940,1230,4,2005,810000
6762813025,1860,9,1860,0,3,2014,799950
6762813115,2720,9,2250,470,4,2014,790000
6762813167,1260,6,1080,180,2,1942,785000
6762814198,1180,8,840,340,1,1910,713000
6762814559,2780,8,2780,0,4,2001,690000
6762814815,2250,9,2250,0,3,2004,675000
6762815482,2480,8,2480,0,3,1998,640000
6762815525,1830,7,930,900,4,1939,639000
6762815959,1880,7,1880,0,5,1955,618000
6762816311,1440,8,1440,0,3,1929,600000
6762816477,2050,8,2050,0,4,1984,595000
6762816565,2340,9,2340,0,4,1987,590000
6762816620,1920,7,1060,860,4,1919,589000
6762816621,1720,8,1460,260,3,2006,589000
6762817964,3160,10,1740,1420,5,1978,540000
6762818187,2130,8,2130,0,3,1977,534950
6762818380,2240,7,1440,800,3,1979,527000
6762818565,1710,8,1710,0,3,1966,522500
6762819111,1640,7,1140,500,2,1954,500000
6762819456,2815,9,2815,0,5,2011,491000
6762819959,1270,6,1270,0,3,1959,475000
6762820054,1050,6,1050,0,2,1905,474000
6762820186,2970,8,1670,1300,5,1969,469500
6762820284,3360,9,3360,0,4,1988,465000
6762820285,1220,8,1110,110,2,2008,465000
6762820628,1600,7,1600,0,3,1987,455000
6762821131,2800,8,2800,0,4,2002,444000
6762821579,1930,7,1420,510,3,1961,432500
6762821873,1320,7,1320,0,3,1959,425000
6762822079,2020,7,1010,1010,3,1975,420000
6762822080,2060,8,1460,600,3,1967,420000
6762822595,1070,6,1070,0,2,1940,406650
6762822650,1090,7,780,310,2,1981,405000
6762822715,1060,6,950,110,4,1904,403504
6762822771,3140,8,2280,860,4,1977,401500
6762822837,1810,7,1810,0,4,1977,400000
6762823079,1360,7,1120,240,3,2003,396500
6762823272,1790,7,1220,570,4,1987,390000
6762823273,2500,8,2120,380,4,1975,390000
6762823488,2160,7,1260,900,3,1928,385000
6762823567,2370,8,2370,0,4,1966,383000
6762823613,3060,8,3060,0,5,2003,381000
6762823646,2500,8,1300,1200,4,1964,380000
6762823647,2300,8,2300,0,4,2004,380000
6762823867,1670,8,1670,0,3,1968,375000
6762823868,1940,8,970,970,4,1974,375000
6762824045,1790,7,1790,0,4,2005,370500
6762824175,2810,7,1520,1290,5,1965,368500
6762824803,2470,7,1420,1050,4,1985,352000
6762824879,2260,9,2260,0,4,1975,350000
6762825779,2120,7,1060,1060,6,1983,330000
6762825780,1340,7,1340,0,3,1961,330000
6762825897,1500,7,1170,330,3,1989,329500
6762825948,830,6,830,0,2,1950,327500
6762825960,1630,7,1630,0,4,1999,327000
6762825979,1782,7,1782,0,3,2000,326000
6762826029,1960,7,1960,0,4,2004,325000
6762826030,1400,7,1400,0,2,1974,325000
6762826272,2190,8,2190,0,4,1978,320000
6762826273,2070,7,2070,0,4,1996,320000
6762826443,1900,7,1900,0,3,1992,316000
6762826488,2080,7,1680,400,4,1950,315000
6762826879,2007,9,2007,0,4,2009,305950
6762826911,2050,7,2050,0,4,1978,305000
6762827546,2340,8,1590,750,4,1960,290000
6762827855,2100,8,2100,0,4,1978,283500
6762827945,1370,7,1370,0,3,1993,280000
6762828059,1780,7,1240,540,3,1960,279000
6762828405,1400,7,1400,0,3,2012,270000
6762828525,1670,8,1670,0,4,1974,268500
6762828558,2390,7,2390,0,5,1977,267500
6762828630,1850,7,1850,0,3,1992,265000
6762828778,1660,7,1660,0,3,1957,261000
6762829025,1250,6,1250,0,3,1972,255000
6762829602,1100,7,1100,0,3,1949,241450
6762829766,1210,7,1210,0,3,1985,237000
6762830142,1360,6,1360,0,2,2003,225000
6762830143,1660,7,980,680,3,1962,225000
6762830254,1430,7,1430,0,3,1987,221000
6762830343,1200,7,1200,0,3,1986,219000
6762830434,1010,6,1010,0,2,1944,215000
6762830647,820,6,820,0,2,1955,207000
6762830977,1390,7,1130,260,3,1980,190500
6762830988,1400,7,960,440,2,1982,190000
6762831063,900,6,900,0,2,1954,185000
6762831100,670,6,670,0,2,1926,183000
6762831231,1040,6,1040,0,3,1954,172500
6762810140,3800,10,3800,0,4,1969,2400000
6762810971,3670,10,3670,0,4,1986,1220000
6762811352,3950,8,3950,0,4,1960,1050000
6762811353,3180,9,1990,1190,4,1929,1050000
6762811761,2700,9,2700,0,3,2013,950000
6762812128,1710,8,1710,0,4,1926,895000
6762812212,3070,8,2100,970,4,1958,880000
6762812303,3210,10,2530,680,3,1990,870000
6762812418,3120,9,1820,1300,3,1978,855000
6762812691,3310,9,2910,400,4,1900,829000
6762812720,3040,10,3040,0,3,1987,825000
6762812956,2110,9,1760,350,2,1960,802000
6762812983,1050,7,1050,0,2,1951,800000
6762813103,3350,9,3350,0,4,2014,790500
6762813116,2840,9,1640,1200,4,1961,790000
6762813303,2740,8,1820,920,4,1947,775000
6762813352,2500,7,1250,1250,4,1958,772000
6762813423,2250,9,1830,420,3,1909,765000
6762813624,2250,8,1510,740,3,1975,750000
6762813625,2460,8,1940,520,3,1976,750000
6762813780,3350,10,3350,0,4,2004,740000
6762814163,2450,8,1250,1200,4,1958,715000
6762814463,2580,9,2580,0,3,2006,698000
6762814747,3600,9,3600,0,5,2014,679950
6762816478,2000,7,1130,870,4,1949,595000
6762817788,1850,7,950,900,3,1940,547500
6762817840,1900,9,1900,0,3,1996,545000
6762818017,1560,7,1560,0,3,1910,539950
6762818135,1320,8,1320,0,3,2008,535000
6762818540,1990,8,1850,140,4,1968,524400
6762818606,2280,8,2280,0,4,1987,520000
6762818672,2560,8,2560,0,4,2005,518000
6762818844,1270,7,1270,0,3,1957,510500
6762819112,1560,7,1400,160,3,1978,500000
6762819272,1460,8,1180,280,3,2007,499000
6762819485,2370,7,2370,0,3,1970,490000
6762819596,3530,7,2380,1150,5,1999,487500
6762819708,3300,8,2060,1240,6,1980,484000
6762819787,1170,6,690,480,2,1924,480000
6762819877,2790,8,1410,1380,3,1970,478000
6762819960,1380,6,1380,0,3,1919,475000
6762819961,2160,8,2160,0,3,1982,475000
6762820133,1170,7,870,300,3,1951,470000
6762820134,1990,8,1990,0,4,1998,470000
6762820286,2140,7,1470,670,4,1977,465000
6762820819,1670,8,1670,0,3,2000,450000
6762821155,1780,7,1290,490,3,1980,442573
6762821481,2400,8,1640,760,6,1987,435000
6762821482,1380,7,750,630,3,1986,435000
6762822259,1150,7,1150,0,3,1957,415950
6762822305,760,7,760,0,1,1900,415000
6762822553,1950,7,1950,0,3,2007,409000
6762822568,1500,8,1120,380,3,2000,408000
6762822589,2927,7,2927,0,4,2011,407000
6762823097,1590,8,1590,0,2,2012,395825
6762823221,940,7,810,130,2,1925,392000
6762823274,2360,8,2360,0,3,2003,390000
6762823489,1800,8,1200,600,3,1968,385000
6762823648,1370,8,1370,0,2,1986,380000
6762823812,2420,7,1420,1000,6,1965,376000
6762823869,2100,8,2100,0,4,1975,375000
6762824009,1920,8,1920,0,4,1968,372500
6762824185,1750,7,1750,0,3,1951,368000
6762824197,2290,7,1250,1040,3,1950,367950
6762824216,2000,7,1200,800,3,1965,367000
6762824264,3260,8,3260,0,5,2004,365000
6762824880,1320,7,1320,0,3,1995,350000
6762824881,1680,7,1680,0,3,1991,350000
6762825585,1660,7,1660,0,2,1958,335000
6762825781,2080,8,1400,680,4,1989,330000
6762826212,1760,7,1160,600,3,1988,322000
6762826489,3220,8,3220,0,5,2002,315000
6762826703,1880,7,1280,600,4,1976,310000
6762826778,1120,7,1120,0,1,1950,309950
6762826912,1000,6,1000,0,4,1947,305000
6762826913,2510,8,1520,990,4,1977,305000
6762827263,2100,7,2100,0,3,1983,299000
6762827264,960,7,960,0,3,1955,299000
6762827777,1690,7,870,820,3,1997,285000
6762827854,1010,6,1010,0,1,1968,283700
6762828092,2400,8,2400,0,4,1964,278000
6762828197,2090,7,1090,1000,2,1931,275000
6762828473,1740,7,1740,0,3,1962,269950
6762829357,2120,7,1380,740,3,1961,249000
6762829930,2080,7,1280,800,4,1985,231500
6762830144,1150,6,1150,0,4,1907,225000
6762830207,1070,7,1070,0,3,1994,224400
6762830255,1150,7,1150,0,3,1959,221000
6762830276,1470,7,1160,310,3,1985,220000
6762830400,1310,6,1310,0,3,1984,216000
6762830482,1430,6,1430,0,3,1968,213950
6762830648,860,6,860,0,3,1960,207000
6762830662,1720,7,1720,0,5,1970,206325
6762830860,880,6,880,0,2,1916,199400
6762830867,1320,7,1320,0,3,1956,199000
6762831159,920,6,920,0,3,1969,179000
6762810291,2800,9,2800,0,5,1963,1850000
6762810372,4160,12,3690,470,3,2001,1700000
6762810709,4960,11,3760,1200,5,2001,1360000
6762811011,2710,10,2380,330,5,1974,1200000
6762811079,2910,9,1780,1130,5,1972,1170000
6762811117,4590,9,2500,2090,10,2008,1150000
6762811219,3700,10,2170,1530,3,2000,1100000
6762811463,3430,11,3430,0,4,2005,1010000
6762811601,2390,8,2090,300,3,1941,980000
6762811630,3420,9,2270,1150,6,1948,975000
6762811762,2790,10,2790,0,4,1964,950000
6762812020,3680,10,3680,0,4,1986,909000
6762812065,3690,11,3690,0,4,1987,900000
6762812169,3210,9,3210,0,4,2014,889000
6762812258,2820,8,1930,890,6,1917,875000
6762812626,2520,8,1700,820,3,1944,835000
6762812800,1850,8,1650,200,3,1913,819000
6762812984,1930,7,1930,0,5,1930,800000
6762813168,3310,9,3310,0,4,2010,785000
6762813452,2750,9,2750,0,4,1989,763776
6762813491,2840,9,1990,850,4,1974,760000
6762813966,2310,8,2310,0,7,1984,727160
6762814605,3400,10,3400,0,4,1998,688000
6762814638,2650,9,2330,320,4,1954,685000
6762814674,2300,9,2300,0,3,1998,683000
6762814679,2760,9,2760,0,5,2005,682000
6762814707,2530,7,1390,1140,8,1901,680000
6762814753,2770,8,2770,0,3,1957,679000
6762814889,2160,7,1530,630,5,1927,671500
6762815156,2560,8,2560,0,5,1995,655000
6762816097,1960,8,1960,0,4,1973,610000
6762816269,2160,8,1660,500,4,1998,601000
6762816459,2270,8,1720,550,4,1974,596000
6762817613,2410,8,2060,350,4,1936,550000
6762817782,2100,7,2100,0,4,1958,548000
6762817965,1850,8,1850,0,4,1985,540000
6762817966,1630,7,980,650,4,1918,540000
6762817967,2260,8,1450,810,4,1971,540000
6762818269,3150,9,3150,0,3,2006,530000
6762818441,2880,7,2880,0,6,1980,525000
6762818960,1810,8,1450,360,3,1984,507000
6762819113,3040,9,3040,0,3,2008,500000
6762819114,2990,9,2990,0,3,1994,500000
6762819643,2460,7,1380,1080,5,1972,485000
6762819644,1130,7,1130,0,2,1916,485000
6762820247,1360,7,1060,300,3,1963,466950
6762820421,1850,7,1150,700,3,1977,461000
6762820820,1810,7,1400,410,3,1977,450000
6762820821,2450,10,2450,0,3,1990,450000
6762820822,2290,8,2290,0,4,2006,450000
6762820947,1470,7,1470,0,3,1988,449950
6762821015,1650,7,1650,0,3,2003,447000
6762821031,1480,7,1480,0,3,1960,446450
6762821079,1550,8,1060,490,3,2006,445000
6762821243,2060,8,2060,0,3,1987,440000
6762821770,2150,8,2150,0,3,1988,428040
6762822016,1700,7,1700,0,4,1967,423000
6762822306,1070,7,1070,0,2,1937,415000
6762822838,2350,8,2000,350,6,1905,400000
6762823621,1920,7,1920,0,3,1998,380600
6762823870,3120,7,2150,970,3,1980,375000
6762823871,2310,8,2310,0,4,2011,375000
6762823964,1970,7,1970,0,4,1963,374950
6762824337,2080,8,2080,0,4,1969,364000
6762824538,2200,7,2200,0,3,1952,359000
6762824882,900,6,900,0,1,1947,350000
6762825279,1740,8,1320,420,3,2008,342000
6762825541,1120,7,1120,0,2,1939,335900
6762825782,520,4,520,0,2,1924,330000
6762825934,1990,7,1990,0,4,2002,328000
6762826145,2320,7,1160,1160,4,1959,324950
6762826174,820,7,820,0,2,1941,324000
6762826186,2500,7,1300,1200,5,1962,323000
6762826785,2020,7,2020,0,3,1987,309900
6762826868,2267,7,2267,0,4,2014,306000
6762827319,1840,8,1840,0,3,1994,297000
6762827441,2040,7,2040,0,4,2003,294000
6762827638,960,6,820,140,3,1944,289500
6762827946,1940,7,1140,800,4,1954,280000
6762828406,1850,7,1100,750,4,1956,270000
6762828407,1300,8,850,450,3,2006,270000
6762829026,880,6,500,380,1,1910,255000
6762829027,1830,7,1400,430,3,1977,255000
6762829323,1320,7,1320,0,3,1968,249950
6762829375,720,6,720,0,2,1949,248500
6762829477,2040,6,810,1230,3,1910,245000
6762829564,2110,6,2110,0,3,1981,243500
6762830145,1120,6,1120,0,3,1961,225000
6762830277,1070,6,1070,0,3,1956,220000
6762830278,1460,7,1460,0,3,1957,220000
6762830379,1400,7,1400,0,3,1962,217000
6762831273,1050,7,1050,0,3,1953,169100
6762810300,6030,11,4440,1590,3,1991,1830000
6762810539,4370,11,3270,1100,5,1990,1500000
6762810646,3560,10,2560,1000,4,2014,1400000
6762810832,3700,11,3700,0,4,1989,1290000
6762811398,3770,11,3770,0,4,1997,1040000
6762811907,2560,10,2110,450,3,1994,925000
6762811908,3640,10,3640,0,4,2005,925000
6762812066,3950,10,2050,1900,4,1955,900000
6762812067,1980,8,1700,280,4,1910,900000
6762812326,2970,9,2200,770,4,2001,866800
6762812551,3090,10,3090,0,4,1988,844000
6762812782,2970,9,2970,0,3,1994,820000
6762813169,2090,7,2090,0,3,1920,785000
6762813226,3430,9,3050,380,4,2006,780000
6762813353,2990,9,2990,0,4,2003,772000
6762813626,2280,8,1360,920,3,1941,750000
6762813781,2500,10,2500,0,4,1992,740000
6762813886,1740,8,950,790,3,1930,733000
6762814081,3420,9,3420,0,4,2007,720000
6762814235,2930,8,2930,0,3,1990,710000
6762815038,1260,7,1260,0,2,1939,661000
6762815127,980,6,980,0,3,1942,657500
6762815262,1340,7,1340,0,3,1913,650000
6762815483,1530,7,1530,0,3,1950,640000
6762815781,2070,8,1390,680,4,1977,625000
6762816164,2060,7,1060,1000,3,1921,607000
6762816566,2680,7,2680,0,3,1984,590000
6762817462,1780,7,1080,700,2,1947,555000
6762817614,2060,8,1320,740,4,1960,550000
6762817841,1700,7,1450,250,3,1925,545000
6762818806,920,7,920,0,2,1906,514000
6762819115,1220,8,1220,0,3,2014,500000
6762819224,1730,8,1220,510,3,1977,499990
6762819364,2740,8,2240,500,4,2003,495000
6762819486,1490,8,1490,0,3,1975,490000
6762819962,2010,6,1510,500,5,1912,475000
6762819963,2770,9,2770,0,3,1991,475000
6762821874,1340,7,1340,0,3,1976,425000
6762822651,1740,7,1230,510,3,1989,405000
6762823872,1160,7,1160,0,2,2002,375000
6762823997,1400,7,840,560,3,2002,373000
6762825160,1010,6,1010,0,3,1904,345000
6762825242,2060,7,2060,0,4,2002,343888
6762825783,860,6,860,0,1,1907,330000
6762825784,1040,6,1040,0,3,1972,330000
6762827112,1830,7,1830,0,3,1991,300000
6762827113,1580,7,1050,530,4,1965,300000
6762828121,1190,8,920,270,3,2014,277140
6762828198,2180,8,1620,560,4,1978,275000
6762828495,1140,6,1140,0,2,1968,269500
6762828631,770,6,770,0,2,1943,265000
6762828886,1350,7,1350,0,3,1968,259950
6762829324,1370,6,1370,0,3,1958,249950
6762830028,1670,7,1030,640,4,1977,229999
6762830236,1440,7,970,470,3,1981,222000
6762830477,1200,6,1200,0,3,1953,214000
6762830641,1170,6,1170,0,3,1966,207500
6762830989,840,6,840,0,2,1994,190000
6762831043,1050,8,1050,0,2,1974,187000
6762831515,880,5,880,0,2,1928,130000
6762811716,3550,11,3550,0,4,2004,959900
6762813816,2840,7,1620,1220,5,1913,739000
6762826274,1330,7,930,400,3,1954,320000
6762829231,740,6,740,0,2,1942,250000
6762812419,2810,9,2810,0,4,1988,855000
6762814236,2830,10,2830,0,3,1991,710000
6762816098,3440,11,3440,0,3,1991,610000
6762823649,1240,7,1240,0,3,1973,380000
6762811062,2570,8,1750,820,4,1909,1180000
6762811080,4610,11,4610,0,5,2004,1170000
6762811559,2430,8,2020,410,4,1919,990000
6762811602,3780,10,3780,0,4,1990,980000
6762812649,3560,10,2590,970,4,2006,833000
6762812653,1870,7,1870,0,3,1951,832500
6762812697,3520,10,3520,0,4,1998,828000
6762813973,2040,8,1420,620,3,1974,726000
6762814272,3180,8,1910,1270,5,1968,708000
6762814297,2570,7,1970,600,6,1911,705000
6762814560,2780,9,2780,0,4,2003,690000
6762815357,2240,8,1120,1120,4,1961,649000
6762815454,2760,8,1900,860,4,2014,641000
6762815484,2580,9,2580,0,3,1991,640000
6762815642,2360,7,1180,1180,3,1940,631750
6762815782,1490,7,1190,300,2,1900,625000
6762815783,1240,7,1240,0,3,1925,625000
6762815845,2710,8,1440,1270,4,1961,624000
6762816312,1830,9,1530,300,2,2011,600000
6762816808,3110,8,1720,1390,5,1974,580000
6762816883,1500,7,1120,380,3,1938,578000
6762817504,1470,7,1470,0,3,1900,554600
6762817615,2890,8,2890,0,4,2001,550000
6762818018,3100,7,3100,0,5,2006,539950
6762818136,2790,9,2790,0,3,1990,535000
6762818270,2010,8,2010,0,3,1986,530000
6762818739,1740,7,1400,340,4,1946,515000
6762818864,1060,6,880,180,4,1925,510000
6762819116,1960,7,1020,940,3,1958,500000
6762820050,1630,7,1630,0,3,1948,474900
6762820195,1370,8,1370,0,3,2004,469000
6762820196,1120,6,730,390,2,1921,469000
6762820214,1480,8,1390,90,2,2007,468000
6762820454,1650,7,1220,430,3,1975,460000
6762820686,880,7,880,0,2,1950,454000
6762820974,2090,8,1680,410,4,1941,449000
6762821039,2280,7,1140,1140,4,1957,446000
6762821040,1530,7,1020,510,4,1974,446000
6762821162,1540,7,1540,0,4,1935,442500
6762821875,1740,8,1740,0,3,1969,425000
6762822222,1160,6,1160,0,3,1917,417500
6762822486,1480,7,1050,430,2,1949,410000
6762822738,990,7,990,0,3,1929,402500
6762822949,1020,7,1020,0,3,1969,399950
6762823275,2020,7,1100,920,4,1975,390000
6762823650,1840,8,1840,0,3,1990,380000
6762823651,1200,7,1200,0,1,1983,380000
6762823799,1820,6,1820,0,3,1967,377000
6762824072,1440,7,1440,0,3,1928,370000
6762824400,3300,8,1650,1650,3,1961,360500
6762824657,2160,9,1660,500,4,1976,355000
6762824658,840,7,840,0,2,1952,355000
6762824786,1470,7,1470,0,3,1953,352500
6762824883,1020,7,850,170,3,1941,350000
6762825161,1350,7,920,430,2,1949,345000
6762825234,1250,8,1250,0,3,2007,344000
6762825437,2420,8,2420,0,3,1990,339900
6762825479,1590,7,1590,0,3,1992,338000
6762825692,1050,7,1050,0,3,1951,333000
6762825785,1850,6,1850,0,3,1943,330000
6762826601,970,6,970,0,2,1911,313300
6762826639,1170,6,980,190,2,1907,312000
6762826661,1180,8,1180,0,2,1941,311000
6762826662,1120,7,1120,0,3,1942,311000
6762826914,1650,7,1220,430,3,1977,305000
6762826915,860,6,860,0,2,1949,305000
6762826978,2270,7,1290,980,4,1976,304999
6762827346,2030,8,1890,140,3,1966,295450
6762827547,960,7,960,0,3,1955,290000
6762827947,1550,7,1550,0,3,1944,280000
6762828060,1210,7,1210,0,4,1943,279000
6762828199,940,6,940,0,2,1951,275000
6762828363,2140,7,1460,680,3,1974,271675
6762828408,1500,6,750,750,3,1942,270000
6762828505,1320,7,1320,0,3,1986,269000
6762828632,1400,7,900,500,5,1954,265000
6762829028,1170,7,1170,0,3,1969,255000
6762829358,1070,6,1070,0,3,1940,249000
6762829972,1450,8,1450,0,3,1978,230000
6762829973,1680,7,1150,530,4,1997,230000
6762830492,1200,7,1200,0,3,1977,213000
6762830679,900,6,900,0,2,1938,205500
6762830798,1770,7,1770,0,5,1959,200000
6762831368,1320,7,1320,0,3,1952,159000
6762810159,4110,12,2720,1390,4,2001,2300000
6762810341,3460,10,3020,440,4,1950,1750000
6762810490,2810,10,2810,0,4,1993,1570000
6762810981,3220,9,2900,320,5,2008,1210000
6762811319,2370,11,2370,0,2,2005,1060000
6762811519,2250,9,2250,0,3,1955,998800
6762811673,2620,7,1570,1050,4,1950,968060
6762811909,4050,9,2230,1820,5,1988,925000
6762812304,3190,11,3190,0,4,1990,870000
6762812318,2750,8,1770,980,6,1987,869900
6762812380,3070,9,3070,0,4,2009,860000
6762812381,2510,8,2010,500,5,1920,860000
6762813096,3100,10,3100,0,4,1999,792000
6762813117,2240,8,1470,770,4,1975,790000
6762813118,2690,9,2690,0,4,1987,790000
6762814082,2120,8,2120,0,3,1981,720000
6762814267,2720,8,2670,50,4,1997,709050
6762814331,2650,8,2650,0,4,2013,702000
6762814780,2800,8,2800,0,4,2003,676000
6762814816,1890,7,1670,220,4,1940,675000
6762815263,3270,9,2110,1160,4,1990,650000
6762815485,2160,8,1960,200,3,1903,640000
6762815578,2230,8,1850,380,3,2013,635000
6762816234,2110,8,1340,770,3,2013,604950
6762816258,1580,8,1580,0,3,1979,602000
6762816313,1620,9,1430,190,3,2005,600000
6762816479,870,7,870,0,2,1924,595000
6762816531,3370,8,1770,1600,4,1993,592500
6762816948,1750,8,1440,310,2,1978,575000
6762818205,2060,8,2060,0,3,1990,533000
6762818442,1520,7,1520,0,3,1957,525000
6762818922,2210,9,2210,0,3,1995,509950
6762819225,2620,8,2620,0,4,2012,499990
6762819739,3010,8,1560,1450,4,1973,482000
6762819964,2120,9,2120,0,4,1989,475000
6762820287,1720,8,900,820,3,1943,465000
6762820687,1590,7,1590,0,3,1991,454000
6762820734,1340,8,1340,0,2,1950,452000
6762820823,1250,7,790,460,2,1920,450000
6762821135,1250,7,750,500,3,1944,443725
6762821180,2050,7,1350,700,3,1958,442000
6762821244,2000,8,2000,0,3,1979,440000
6762821321,2780,7,2780,0,4,1985,439950
6762821751,1700,7,1700,0,3,1991,429000
6762821752,2520,8,1260,1260,3,1957,429000
6762821773,1580,7,1580,0,3,1985,428000
6762821823,1130,7,1130,0,3,1952,426000
6762822010,1890,7,1190,700,3,1987,423500
6762822307,1960,7,980,980,5,1965,415000
6762822487,1510,6,950,560,3,1939,410000
6762822488,1509,8,1509,0,3,2014,410000
6762822839,1180,7,1180,0,2,1984,400000
6762822840,1740,8,1740,0,3,1980,400000
6762822993,2100,8,2100,0,3,2010,399000
6762823490,1820,7,1220,600,4,1950,385000
6762823774,880,7,880,0,2,1949,378500
6762823873,1230,7,1230,0,3,1954,375000
6762823874,1520,7,1520,0,3,1989,375000
6762823965,2120,8,2120,0,3,1992,374950
6762824164,1300,7,1300,0,3,1985,369000
6762824884,2810,8,2810,0,4,2001,350000
6762825162,2382,8,2382,0,4,2011,345000
6762825548,1260,7,1260,0,3,1970,335500
6762825586,2210,8,2210,0,4,2003,335000
6762825587,2160,7,1460,700,4,1965,335000
6762825736,1480,7,1080,400,2,1950,331000
6762825786,1740,8,1320,420,3,2008,330000
6762826031,1050,7,1050,0,2,1969,325000
6762826032,1740,7,1740,0,3,1999,325000
6762826033,750,7,750,0,2,1947,325000
6762826275,2050,8,2050,0,4,1993,320000
6762826779,1460,8,1460,0,2,2007,309950
6762826835,1520,7,1520,0,2,1999,307300
6762826916,1646,7,1646,0,3,1994,305000
6762827006,2100,8,2100,0,4,2003,303000
6762827114,1310,7,1310,0,3,1967,300000
6762827189,1640,6,820,820,4,1944,299999
6762827371,1850,7,1850,0,4,1990,295000
6762827470,2250,7,2250,0,4,2008,292500
6762827948,1780,7,1780,0,3,1964,280000
6762827949,1894,6,1520,374,2,1936,280000
6762828112,1260,7,1260,0,3,1981,277500
6762828819,1600,7,1600,0,5,1962,260000
6762829029,960,7,960,0,2,1977,255000
6762829127,1910,7,1140,770,4,1973,253000
6762829232,950,5,950,0,2,1932,250000
6762829233,750,5,750,0,2,1920,250000
6762829635,1280,6,1280,0,3,1954,240000
6762829767,2000,7,1140,860,3,1979,237000
6762830642,1320,7,1320,0,3,1970,207500
6762830696,940,7,940,0,3,1960,205000
6762831126,1670,7,1670,0,3,1958,180000
6762831276,1470,6,1470,0,3,1916,169000
6762810196,3080,11,2530,550,3,1996,2160000
6762810540,6550,11,5400,1150,4,2006,1500000
6762810568,5220,11,3550,1670,4,2006,1480000
6762811118,4190,10,4190,0,3,1999,1150000
6762811709,3110,10,3110,0,4,1984,960000
6762811736,3490,10,2320,1170,2,1980,952000
6762811844,3680,10,2890,790,4,2008,935000
6762812259,2010,7,1210,800,3,1915,875000
6762812577,2060,8,2060,0,3,1924,840000
6762812642,3470,9,3470,0,3,2008,834800
6762812669,3370,8,2840,530,3,1912,830000
6762813204,1290,7,820,470,3,1952,781000
6762813404,3220,9,2690,530,3,1981,768000
6762813424,3190,9,3190,0,4,1988,765000
6762813492,4660,9,3020,1640,4,2003,760000
6762813718,2110,8,1410,700,3,2014,747450
6762813723,2060,9,1140,920,3,1964,746300
6762813825,2260,8,2260,0,4,1956,738950
6762813856,3040,8,3040,0,4,1966,735000
6762813904,3070,9,3070,0,4,2005,731000
6762814237,1650,8,1650,0,3,1963,710000
6762814496,2650,10,2650,0,4,1990,695000
6762814530,3490,9,2242,1248,3,2009,692000
6762814817,1010,6,1010,0,3,1942,675000
6762815141,1440,8,1290,150,4,1929,656000
6762815204,2220,8,2220,0,4,1989,652500
6762815264,3060,9,3060,0,3,2004,650000
6762815403,2130,7,2130,0,3,1908,645000
6762815486,1960,7,1960,0,3,1915,640000
6762815939,1040,7,800,240,3,1944,619790
6762815951,1990,8,1430,560,3,1927,619000
6762816003,1900,7,950,950,3,1951,615000
6762816199,1920,8,1260,660,3,1977,605000
6762816809,1590,8,1590,0,3,2004,580000
6762816810,1740,8,1740,0,3,2008,580000
6762817203,1540,6,770,770,3,1925,565000
6762817204,1910,7,1390,520,5,1955,565000
6762817342,2930,9,1580,1350,4,1978,560000
6762817616,2760,8,1760,1000,4,1974,550000
6762818137,2360,8,2360,0,4,2014,535000
6762818217,1360,8,1360,0,3,1990,532170
6762818271,1510,8,1510,0,3,2006,530000
6762818443,2470,7,1350,1120,4,1940,525000
6762818444,2840,9,2840,0,4,2002,525000
6762818445,1240,7,800,440,3,1951,525000
6762818581,1890,8,1890,0,4,1967,521000
6762818865,2340,7,1210,1130,3,1929,510000
6762818945,820,7,820,0,2,1953,508000
6762819318,2250,8,2250,0,4,1968,497000
6762819365,1780,7,1780,0,3,1995,495000
6762819716,1200,7,600,600,3,1931,483500
6762819788,1770,7,1770,0,4,1972,480000
6762819861,2590,8,2590,0,4,2001,479000
6762819965,1750,7,1750,0,3,1952,475000
6762820135,1710,8,1360,350,3,2003,470000
6762820394,2010,8,1390,620,3,2014,462608
6762820422,1420,7,1420,0,3,1963,461000
6762820530,2650,7,1350,1300,5,1979,459000
6762820948,1610,7,1610,0,3,1985,449950
6762821245,2800,7,1400,1400,4,1978,440000
6762821246,1430,7,1430,0,3,1961,440000
6762821617,2360,9,2360,0,3,1978,431000
6762821876,1240,6,1240,0,3,1948,425000
6762822232,1300,7,1060,240,3,2008,417000
6762822841,1350,6,1350,0,3,1914,400000
6762822938,2620,8,2620,0,4,2014,399963
6762823049,2130,8,2130,0,3,1987,397500
6762823063,1790,7,1790,0,4,2005,397000
6762823064,3000,7,3000,0,4,2003,397000
6762823121,1960,7,980,980,2,1950,395000
6762823194,1320,8,1320,0,3,1981,393000
6762823207,1600,8,1600,0,3,1998,392500
6762823985,1850,8,1210,640,3,1982,374000
6762824073,2670,8,1400,1270,5,1990,370000
6762824140,1910,8,1910,0,4,1994,369950
6762824207,1570,7,1570,0,3,1963,367500
6762824265,960,6,960,0,2,1985,365000
6762824433,2200,8,2200,0,3,1981,360000
6762824566,930,6,930,0,2,1939,358000
6762824659,2390,7,2390,0,4,2003,355000
6762824885,2010,7,1210,800,3,1967,350000
6762824886,800,6,800,0,2,1960,350000
6762825787,880,6,780,100,2,1937,330000
6762825961,1490,8,1190,300,2,2009,327000
6762826276,1780,6,1780,0,3,1947,320000
6762826378,780,6,780,0,2,1924,319000
6762826444,1270,7,1270,0,3,1971,316000
6762826704,1160,7,1160,0,2,2008,310000
6762827115,2360,7,1180,1180,4,1955,300000
6762827265,2320,7,1720,600,4,1943,299000
6762827332,1370,7,1070,300,4,1953,296000
6762827434,1410,6,1210,200,3,1925,294350
6762827453,1250,7,910,340,4,1979,293550
6762827508,2220,7,2220,0,4,2001,291375
6762828027,1520,7,1160,360,3,1990,279950
6762828093,2170,7,1100,1070,5,1962,278000
6762828574,1580,8,1580,0,3,1993,267000
6762828759,1680,7,1680,0,3,1994,262000
6762828820,1340,7,1340,0,3,1980,260000
6762828821,1580,7,1580,0,3,1911,260000
6762828898,1560,7,1060,500,4,1979,259900
6762829030,1260,6,1260,0,2,1945,255000
6762829359,1580,7,1080,500,3,1976,249000
6762829478,1390,7,1390,0,3,1987,245000
6762829479,1480,7,1480,0,3,1980,245000
6762829636,1340,7,1340,0,3,1978,240000
6762829821,2230,7,1230,1000,3,1966,235000
6762830146,1170,7,1170,0,2,1951,225000
6762830697,1120,7,1120,0,3,1968,205000
6762830917,1300,6,1300,0,3,1975,195000
6762831064,1430,7,1430,0,3,1994,185000
6762831225,1210,7,1210,0,3,1954,173250
6762831303,1250,7,1250,0,3,1978,165000
6762831304,1120,6,1120,0,3,1917,165000
6762810202,3860,10,2630,1230,4,1975,2140000
6762810336,3060,10,3060,0,3,1988,1760000
6762810808,2910,9,1940,970,2,1985,1300000
6762811551,4070,10,4070,0,4,1968,993500
6762811997,3330,8,3330,0,4,1924,911100
6762812129,3500,10,2360,1140,4,1977,895000
6762812336,2900,8,1830,1070,5,1977,865000
6762812578,3730,10,3730,0,4,1997,840000
6762812757,2320,9,1620,700,4,1974,824000
6762812926,2860,8,2290,570,3,1956,805000
6762813261,2130,8,1830,300,2,1950,779000
6762813304,1980,9,1980,0,3,1989,775000
6762813372,2730,10,2730,0,3,1995,770000
6762813548,2160,9,2160,0,3,1986,756000
6762814054,4870,10,3470,1400,5,1983,722500
6762814143,2110,9,2110,0,3,1984,716125
6762814164,2780,10,2780,0,4,1987,715000
6762814606,4000,9,4000,0,4,2007,688000
6762815039,1820,8,1820,0,3,1994,661000
6762815157,1960,7,1080,880,3,1952,655000
6762815623,2490,9,2490,0,3,2003,634000
6762816041,2210,8,1410,800,2,1968,614306
6762816099,2060,8,2060,0,3,1987,610000
6762816314,2320,8,2320,0,3,1974,600000
6762817152,1740,8,1740,0,3,2008,568000
6762818446,1640,8,1640,0,3,1981,525000
6762818607,3000,7,2400,600,11,1918,520000
6762818665,2120,8,1420,700,4,1985,518500
6762818977,2790,8,2790,0,4,2013,505657
6762818993,1500,8,1500,0,3,2002,505000
6762819487,2120,8,1280,840,4,1975,490000
6762819488,1280,8,1080,200,3,2008,490000
6762819561,1680,7,1680,0,3,1940,489900
6762819604,1470,8,1470,0,2,2005,487000
6762819878,1960,7,980,980,2,1904,478000
6762819966,1930,7,1500,430,3,1983,475000
6762820398,2350,7,1390,960,3,1977,462500
6762820455,1830,7,930,900,2,1946,460000
6762820735,1880,7,880,1000,3,1922,452000
6762820824,1639,8,1479,160,3,2003,450000
6762820825,2150,8,1610,540,3,1966,450000
6762821163,1510,7,1510,0,2,1987,442500
6762821247,1280,7,850,430,2,1983,440000
6762821753,1840,7,1840,0,4,2010,429000
6762821805,1600,8,1310,290,4,1950,427000
6762822152,1690,8,1150,540,3,2014,419990
6762822308,2020,6,1760,260,3,1949,415000
6762822419,1660,7,1260,400,3,1952,412000
6762822420,910,7,910,0,2,1939,412000
6762823595,2530,8,1850,680,4,2014,382000
6762823721,2680,8,2680,0,4,2011,379950
6762823875,1810,7,1810,0,2,1943,375000
6762823998,1830,8,1430,400,3,1958,373000
6762824074,1650,7,1650,0,3,1988,370000
6762824159,2120,8,2120,0,4,1965,369160
6762824208,1960,7,1960,0,4,1980,367500
6762824507,1240,7,1040,200,2,1939,359950
6762824787,1920,8,1920,0,3,1992,352500
6762824788,1360,7,1360,0,3,1955,352500
6762824887,2740,7,1440,1300,4,1972,350000
6762825470,1800,8,1800,0,4,2014,338800
6762825493,1500,7,1500,0,3,1999,337900
6762825588,1950,6,1950,0,4,1931,335000
6762825973,1300,7,1300,0,3,1977,326188
6762826364,1140,7,840,300,3,1985,319900
6762826705,2070,8,1220,850,3,1982,310000
6762826917,1490,7,1490,0,3,1994,305000
6762827223,1470,7,1470,0,3,1958,299900
6762827266,2540,8,1320,1220,3,1969,299000
6762827512,1860,7,1860,0,4,1991,291000
6762827622,2070,8,2070,0,3,1987,289950
6762827778,2360,7,1440,920,4,1965,285000
6762828200,2180,7,1140,1040,5,1963,275000
6762828364,1995,7,1995,0,3,1957,271500
6762828719,1820,7,1820,0,3,1962,264000
6762828726,750,6,750,0,2,1942,263500
6762828822,1480,6,1120,360,3,1940,260000
6762829031,1260,7,810,450,3,2011,255000
6762829480,1490,7,1490,0,3,1989,245000
6762829741,1470,7,1020,450,3,1958,238000
6762830237,1200,7,1200,0,3,1968,222000
6762830561,1400,6,1400,0,3,1948,210000
6762830742,1440,7,970,470,2,1980,203000
6762830990,930,6,930,0,2,1946,190000
6762831086,1230,6,1230,0,2,1911,184900
6762831127,840,5,840,0,3,1945,180000
6762831163,930,8,930,0,2,1978,178500
6762810521,5990,11,5990,0,4,2004,1530000
6762810557,6880,12,4070,2810,5,2007,1490000
6762810647,3780,9,2510,1270,4,1907,1400000
6762810671,2930,11,1920,1010,3,2000,1390000
6762811012,4310,10,3140,1170,3,1988,1200000
6762811845,3710,10,3710,0,3,1998,935000
6762812143,2120,9,1720,400,3,1959,892500
6762812305,3410,10,3410,0,4,1982,870000
6762812442,1990,7,1990,0,5,1913,852000
6762812594,3660,9,3660,0,4,2014,839990
6762812657,3010,9,3010,0,5,2014,831548
6762812853,2040,9,2040,0,3,1998,812000
6762812874,3847,9,2299,1548,5,1975,810000
6762813227,2880,8,2880,0,5,1921,780000
6762813493,3140,10,2310,830,4,2009,760000
6762813578,2420,9,2420,0,3,1987,752888
6762813627,1890,8,1610,280,2,1905,750000
6762813839,2230,7,1290,940,3,1915,736500
6762813887,1930,7,1450,480,4,1924,733000
6762814621,2760,10,2760,0,4,1999,686000
6762814766,2730,9,2730,0,3,1990,678000
6762814772,2020,8,2020,0,3,1956,677500
6762815040,1750,8,1750,0,2,1964,661000
6762815487,2320,9,2320,0,4,1982,640000
6762815579,2690,9,1720,970,4,1978,635000
6762815784,1100,7,1100,0,2,1919,625000
6762815785,3190,9,3190,0,4,1997,625000
6762815786,2240,8,1250,990,3,1950,625000
6762816058,3240,8,2760,480,5,2014,612995
6762816100,2100,8,1250,850,4,1980,610000
6762816315,4930,9,3930,1000,3,1981,600000
6762816316,2370,8,1600,770,4,1967,600000
6762816317,2600,9,2600,0,4,1999,600000
6762816318,1550,8,1550,0,2,1965,600000
6762816416,2640,8,2640,0,4,1989,599000
6762816639,1930,8,1510,420,4,1972,588000
6762816689,2560,8,1280,1280,5,1960,585000
6762816754,1930,8,1480,450,3,1975,583000
6762817205,2730,9,2730,0,3,1976,565000
6762819117,1650,7,1650,0,3,2003,500000
6762819366,1540,7,960,580,2,1949,495000
6762819451,2230,8,1510,720,3,1974,491500
6762820136,2590,7,2000,590,4,1911,470000
6762820387,1250,7,1250,0,2,1943,463000
6762820395,1320,6,1020,300,3,1940,462600
6762820629,910,8,820,90,2,2006,455000
6762820719,2040,8,2040,0,3,1959,452500
6762820949,2070,7,1230,840,4,1977,449950
6762820975,1810,8,1810,0,3,1998,449000
6762821080,2790,9,2480,310,4,2004,445000
6762821136,1430,8,1430,0,3,2003,443600
6762821393,1210,8,1210,0,2,2007,437500
6762821426,1600,7,1600,0,4,1972,436000
6762821733,3310,9,2380,930,4,1991,429900
6762821877,2270,7,2270,0,4,2006,425000
6762821997,2080,8,2080,0,3,1982,424240
6762822182,1470,8,1470,0,2,1985,419000
6762822421,1000,7,900,100,3,1928,412000
6762822842,1250,7,1250,0,2,1922,400000
6762822843,2090,8,1450,640,3,2001,400000
6762822950,3200,7,3200,0,4,2003,399950
6762823122,1740,6,1740,0,3,1954,395000
6762823184,1370,8,1370,0,3,1988,394000
6762823491,2110,8,2110,0,3,1975,385000
6762823652,1380,7,1380,0,3,1954,380000
6762823876,1240,6,790,450,3,1941,375000
6762823877,2070,7,2070,0,4,1955,375000
6762824037,1110,8,1110,0,2,2000,371000
6762824660,1770,6,1770,0,4,1949,355000
6762824722,1780,7,1130,650,3,1976,354950
6762825163,1200,7,1200,0,3,1952,345000
6762825589,1910,7,1910,0,4,1963,335000
6762825935,890,7,890,0,3,1950,328000
6762826034,900,7,900,0,2,1984,325000
6762826035,1220,6,1220,0,1,1946,325000
6762826146,2641,7,2641,0,4,1998,324950
6762826490,1010,7,1010,0,3,1975,315000
6762826706,1590,7,1590,0,3,2000,310000
6762827237,2010,8,2010,0,4,1986,299500
6762827779,2110,6,1220,890,3,1955,285000
6762827853,1940,7,1940,0,3,1989,283748
6762827883,1260,8,1020,240,3,2007,282000
6762828039,1280,6,1280,0,3,1942,279900
6762828201,2060,7,1210,850,4,1978,275000
6762828474,1660,7,1660,0,3,1996,269950
6762828506,1610,7,1610,0,4,1958,269000
6762828575,940,6,940,0,3,1942,267000
6762828633,1320,7,1320,0,3,1993,265000
6762828634,1640,7,1640,0,3,1991,265000
6762828703,1990,7,1990,0,4,1994,264950
6762829153,1570,7,1180,390,3,1991,252000
6762829234,1960,7,1490,470,3,1984,250000
6762829235,1640,6,1640,0,3,1975,250000
6762829724,1130,7,1130,0,2,1954,239000
6762829822,1010,7,1010,0,2,1941,235000
6762830109,970,6,970,0,3,1968,226000
6762830213,1440,7,1440,0,3,1977,224000
6762830279,1660,6,1010,650,4,1952,220000
6762830698,1800,8,1800,0,3,1989,205000
6762830738,770,6,770,0,2,1913,203700
6762830799,930,6,930,0,2,1938,200000
6762831065,820,5,820,0,2,1923,185000
6762831305,1660,7,1660,0,3,1983,165000
6762810809,2860,10,2130,730,4,1933,1300000
6762813960,2650,9,2650,0,4,1994,728000
6762815787,2190,9,1520,670,4,1989,625000
6762815900,1670,8,1670,0,3,1957,620000
6762820703,2330,9,1920,410,3,2004,453000
6762824361,2245,8,2245,0,4,2014,362865
6762829974,1340,7,1340,0,2,1992,230000
6762822489,1760,7,1160,600,3,1966,410000
6762826036,1820,7,1220,600,4,1975,325000
6762810061,3920,11,3920,0,3,1996,3100000
6762810185,3570,8,2070,1500,3,1946,2200000
6762810632,4920,10,4280,640,4,2012,1410000
6762810772,2410,10,2290,120,5,1968,1320000
6762811354,4320,11,3190,1130,4,2006,1050000
6762811489,3320,11,2950,370,4,2008,1000000
6762811490,3350,8,2180,1170,5,1912,1000000
6762811619,3120,8,1660,1460,4,1956,976000
6762811696,3780,9,3780,0,4,1997,962800
6762811977,3140,9,2500,640,3,2001,915000
6762812005,2180,8,1660,520,3,1966,910000
6762812068,2850,8,1680,1170,3,1952,900000
6762812369,2520,8,1270,1250,3,1931,861000
6762812478,3150,8,2460,690,5,1911,850000
6762812521,4010,10,4010,0,4,2004,849000
6762812698,2120,8,1500,620,4,1979,828000
6762812783,3170,8,3170,0,4,2008,820000
6762812843,2840,8,1420,1420,4,1952,814000
6762812859,2510,9,2510,0,2,1943,811000
6762813170,2220,8,1970,250,4,1925,785000
6762813305,1640,7,1640,0,3,1946,775000
6762813581,2360,8,2360,0,4,1974,752500
6762813876,3280,10,3280,0,4,2003,734500
6762813967,3150,9,3150,0,4,2001,727000
6762814238,2430,7,1620,810,3,1949,710000
6762814239,2630,9,1700,930,4,1977,710000
6762815066,2260,8,1660,600,3,2002,660000
6762815952,2560,9,2560,0,3,2002,619000
6762815984,2140,7,1840,300,4,1945,615750
6762816146,1390,7,1010,380,2,1913,608000
6762816200,2960,8,2960,0,3,1979,605000
6762816443,2030,8,1330,700,4,1985,598000
6762816454,2120,7,1720,400,4,1927,597000
6762816622,3930,8,3070,860,5,1968,589000
6762816690,1670,7,1670,0,3,1912,585000
6762816811,1460,8,1460,0,4,2008,580000
6762817047,1350,8,1350,0,4,1930,571000
6762817512,1830,7,1290,540,3,1909,554000
6762818138,1380,7,860,520,3,1925,535000
6762818192,2120,7,1200,920,5,1959,534000
6762818272,2690,8,2690,0,4,1980,530000
6762818273,2480,9,2480,0,3,1992,530000
6762818447,1720,7,860,860,4,1949,525000
6762818535,1750,7,1230,520,3,1929,524950
6762818554,1600,7,800,800,2,1950,523500
6762818740,1920,8,1920,0,3,1972,515000
6762818814,1500,8,1500,0,3,2007,513000
6762818952,2270,8,2270,0,3,2003,507250
6762819118,960,7,960,0,2,1900,500000
6762819119,1960,8,1960,0,4,1984,500000
6762819273,1320,8,990,330,2,2014,499000
6762819895,2100,7,2100,0,3,2006,477000
6762820083,1740,7,1740,0,3,1955,472000
6762820288,2190,8,2190,0,4,2004,465000
6762820456,1440,7,1440,0,3,1980,460000
6762820524,1170,7,1170,0,2,2003,459500
6762820704,1430,7,1430,0,3,1964,453000
6762820757,1620,8,1620,0,4,1955,451000
6762820826,1360,7,1360,0,3,1957,450000
6762821248,2300,7,1190,1110,4,1961,440000
6762821322,1210,7,910,300,2,1906,439950
6762821367,1490,7,770,720,3,1912,438500
6762821878,1570,7,1200,370,3,1983,425000
6762822759,1580,7,1580,0,3,1947,402000
6762823056,2650,8,2650,0,4,1993,397450
6762823222,1090,6,790,300,3,1945,392000
6762823653,1120,6,1120,0,2,1947,380000
6762823800,950,6,950,0,1,1929,377000
6762823986,1330,7,1330,0,3,1976,374000
6762824075,2130,7,2130,0,4,1930,370000
6762824076,2120,7,2120,0,3,1958,370000
6762824077,2313,9,2313,0,3,2011,370000
6762824266,1800,7,1080,720,4,1979,365000
6762824434,3730,7,2150,1580,4,1974,360000
6762824435,1180,6,590,590,2,1945,360000
6762824567,1150,7,1150,0,3,1955,358000
6762824888,2060,8,2060,0,4,1957,350000
6762825013,2000,7,2000,0,4,2005,349950
6762825014,2140,7,2140,0,3,1991,349950
6762825038,1260,7,1260,0,3,1969,349500
6762825480,2370,8,2370,0,4,1999,338000
6762825481,2440,6,1640,800,3,1933,338000
6762825590,2370,8,2370,0,4,2001,335000
6762825788,2430,8,2430,0,4,1983,330000
6762825789,2510,8,2510,0,4,1991,330000
6762826445,1130,6,1130,0,3,1942,316000
6762826918,2280,7,2280,0,4,2006,305000
6762827116,1750,7,1750,0,3,2005,300000
6762827299,860,6,860,0,2,1948,298800
6762827372,1500,6,1500,0,3,1925,295000
6762827548,1500,7,1210,290,3,1968,290000
6762827549,1310,7,1310,0,3,1965,290000
6762827550,1020,8,1020,0,2,2008,290000
6762827748,2200,8,2200,0,3,1988,285167
6762828409,1930,7,1930,0,4,1946,270000
6762828535,1480,7,980,500,3,1980,268000
6762828576,800,6,800,0,1,1919,267000
6762828887,1540,7,1540,0,4,1948,259950
6762829141,2600,7,1570,1030,4,1961,252500
6762829768,1800,7,1800,0,3,1950,237000
6762829787,1380,7,790,590,3,1971,235500
6762829823,1210,7,1210,0,3,1930,235000
6762830032,1900,7,1900,0,3,1988,229950
6762830147,1750,7,1180,570,3,1979,225000
6762830486,1220,7,1220,0,3,1968,213500
6762830732,1000,7,1000,0,3,1968,204000
6762830918,1190,7,1190,0,3,1956,195000
6762831306,1630,7,1630,0,3,1970,165000
6762831467,480,4,480,0,1,1948,145000
6762810054,4810,11,4810,0,4,2007,3200000
6762810221,3050,9,2330,720,3,1968,2000000
6762810373,3600,9,3600,0,4,1959,1700000
6762810435,3820,10,3820,0,4,2005,1620000
6762811320,3880,10,3880,0,4,2007,1060000
6762811355,3560,9,2970,590,4,1996,1050000
6762811524,4130,10,4130,0,5,2004,998000
6762811945,3140,10,3140,0,4,2006,920000
6762812286,2040,8,1840,200,3,1951,872500
6762812917,3370,10,3370,0,4,1999,806000
6762812927,3160,9,2250,910,4,1992,805000
6762812985,2130,7,1070,1060,4,1922,800000
6762813149,2580,9,2580,0,4,1977,787888
6762813262,2320,8,1420,900,3,1957,779000
6762813459,3150,9,3150,0,4,2005,762500
6762813549,2730,9,2730,0,4,1991,756000
6762813734,1960,8,960,1000,4,1922,745000
6762813782,3140,8,1570,1570,6,1959,740000
6762813857,2960,10,2960,0,3,1989,735000
6762813961,3490,9,3490,0,4,2001,728000
6762815067,2880,7,2080,800,3,1926,660000
6762815136,2530,7,1290,1240,5,1960,657000
6762815265,2790,8,2790,0,3,2002,650000
6762815547,3080,9,3080,0,4,2008,637000
6762815674,1360,6,1360,0,3,1945,630000
6762815731,1940,7,1050,890,3,1927,627000
6762816435,3470,7,2070,1400,4,1993,598600
6762816480,1530,8,1530,0,3,1984,595000
6762816949,1750,7,1750,0,3,1991,575000
6762817123,3230,8,3230,0,4,2012,569950
6762817463,1940,8,1940,0,3,2009,555000
6762817617,2150,7,2150,0,5,1900,550000
6762817618,2470,8,2470,0,4,2013,550000
6762817765,1560,7,1150,410,3,1915,549000
6762818139,2040,7,1120,920,3,1954,535000
6762818448,2340,9,2340,0,3,1986,525000
6762818608,2900,8,2900,0,4,2004,520000
6762818673,2320,8,1510,810,4,1905,518000
6762818741,2890,9,2890,0,4,2003,515000
6762819120,1570,9,1280,290,2,2015,500000
6762819121,2350,7,2350,0,4,1972,500000
6762819122,2040,8,2040,0,4,1998,500000
6762819570,1810,8,1810,0,2,2004,489000
6762819789,1030,7,790,240,2,1918,480000
6762819790,2520,8,1690,830,4,1908,480000
6762820043,2080,7,1460,620,5,1975,474950
6762820137,2150,8,1220,930,4,1979,470000
6762820531,1560,6,960,600,4,1924,459000
6762820827,910,6,910,0,2,1914,450000
6762820990,1300,7,1300,0,3,1912,448500
6762821081,2180,8,2180,0,3,2004,445000
6762821249,1780,7,1780,0,4,1922,440000
6762821556,2010,8,2010,0,4,1973,434000
6762821618,1390,8,970,420,2,1959,431000
6762821667,1710,8,1710,0,4,1983,430000
6762821668,1550,7,1550,0,3,1922,430000
6762821669,2750,8,2750,0,4,2011,430000
6762821879,1430,6,1230,200,2,1921,425000
6762821880,1390,7,1390,0,3,1956,425000
6762822081,820,6,820,0,2,1922,420000
6762822082,2480,10,2480,0,4,2001,420000
6762822083,2020,7,2020,0,3,1995,420000
6762822233,1570,8,1570,0,3,2014,417000
6762822380,1260,7,870,390,3,1941,414900
6762822388,3490,8,3490,0,4,1969,414000
6762822490,1740,7,1740,0,3,1952,410000
6762822772,1509,8,1509,0,3,2014,401500
6762822844,1330,7,1330,0,3,1960,400000
6762822845,1730,8,1730,0,3,1961,400000
6762822951,1470,7,1070,400,3,1950,399950
6762822994,2240,7,1710,530,3,1950,399000
6762823654,1860,7,1860,0,2,2000,380000
6762824078,1010,7,1010,0,2,1984,370000
6762824323,2850,9,2850,0,3,1997,364988
6762824804,1850,7,1850,0,4,1954,352000
6762825064,2060,6,1190,870,2,1924,348140
6762825164,1600,8,1360,240,3,2000,345000
6762825235,2130,7,1440,690,5,1946,344000
6762825591,2520,8,2520,0,4,1987,335000
6762826037,1590,7,1090,500,3,1954,325000
6762826277,1820,7,1820,0,3,1972,320000
6762826425,1358,7,1358,0,3,2007,317000
6762826454,1870,7,990,880,3,1977,315500
6762826707,2370,8,2370,0,3,1994,310000
6762826829,1980,7,1260,720,5,1962,307700
6762827312,1390,8,1390,0,3,1990,297950
6762827435,1550,6,830,720,3,1945,294010
6762827551,1010,7,1010,0,3,1972,290000
6762827649,2110,7,2110,0,3,1985,289000
6762827884,1610,7,1610,0,3,1993,282000
6762828410,1760,7,1160,600,3,1986,270000
6762828496,1640,7,1640,0,3,1991,269500
6762828536,1700,7,1700,0,3,2014,268000
6762828635,1420,7,1420,0,3,1954,265000
6762828636,2300,7,1280,1020,4,1977,265000
6762828637,1630,7,1630,0,3,1985,265000
6762828823,1790,7,1790,0,3,1951,260000
6762828951,1300,7,1300,0,3,1981,257500
6762829032,1610,7,1610,0,2,1952,255000
6762829090,2180,7,1170,1010,4,1977,254950
6762829103,910,6,910,0,2,1943,254000
6762829154,1740,7,910,830,3,1981,252000
6762829175,1300,7,1300,0,3,1967,251000
6762829236,1560,7,1560,0,3,1997,250000
6762829237,2070,8,2070,0,3,1990,250000
6762829637,1520,8,1520,0,3,1966,240000
6762829824,820,6,820,0,2,1954,235000
6762829825,910,6,910,0,2,1936,235000
6762829826,2150,7,1260,890,2,1917,235000
6762829975,880,7,880,0,3,1978,230000
6762830401,860,6,860,0,2,1942,216000
6762830504,1250,7,1250,0,4,1971,212000
6762830649,1080,7,1080,0,3,1962,207000
6762830699,1370,7,1370,0,3,1969,205000
6762830726,1130,7,1130,0,2,1956,204950
6762831224,600,6,600,0,2,1922,174000
6762831532,610,5,610,0,1,1922,126000
6762810413,4285,10,3485,800,4,1946,1650000
6762810569,3050,9,2330,720,4,1926,1480000
6762810899,3830,11,3830,0,4,1990,1250000
6762811013,4560,12,2230,2330,4,1995,1200000
6762811255,3410,9,2680,730,4,2007,1090000
6762811356,4210,9,3260,950,4,2014,1050000
6762811357,3400,8,2300,1100,3,2014,1050000
6762811612,4133,11,4133,0,4,2000,979500
6762811669,2830,10,2830,0,3,2014,969950
6762811740,3250,8,3250,0,5,1968,951000
6762811763,2250,9,1880,370,3,1905,950000
6762811764,3080,9,3080,0,3,2000,950000
6762811846,3510,11,3510,0,4,2001,935000
6762812036,2980,9,2340,640,4,2008,905000
6762812069,4350,10,2950,1400,5,1972,900000
6762812721,1150,6,1150,0,2,1908,825000
6762812908,2550,8,1750,800,3,1957,808000
6762813228,3640,10,3640,0,4,1999,780000
6762813425,2170,8,2170,0,2,2012,765000
6762814083,2530,8,2070,460,4,1917,720000
6762814147,2480,8,1900,580,4,1975,716000
6762814450,2740,10,1510,1230,3,1977,699000
6762814451,2680,9,2680,0,3,2001,699000
6762814497,1570,9,1570,0,2,2007,695000
6762814561,2430,9,1430,1000,3,1978,690000
6762815404,1995,8,1995,0,2,1991,645000
6762815449,2220,10,2220,0,3,1990,641250
6762815488,2020,7,2020,0,4,1969,640000
6762815638,2260,8,1520,740,5,1967,632000
6762815788,2330,8,2330,0,3,2003,625000
6762815862,2260,7,1380,880,3,1928,622500
6762816417,2120,8,2120,0,4,2005,599000
6762816539,2400,8,2400,0,3,1985,592000
6762817032,2200,8,2200,0,3,2002,572000
6762817206,2280,8,2280,0,4,2003,565000
6762817530,2560,8,1280,1280,4,1957,552625
6762817558,3090,10,3090,0,5,2010,551000
6762817842,2390,8,2390,0,4,1969,545000
6762817968,3100,8,3100,0,5,2002,540000
6762818074,1560,7,1140,420,4,1945,537000
6762818140,2710,8,1700,1010,4,1968,535000
6762818710,2210,8,1170,1040,4,1997,516000
6762818742,1640,8,1640,0,3,1962,515000
6762819123,2100,7,2100,0,4,1972,500000
6762819338,2130,7,1720,410,3,1959,495500
6762819441,2100,8,2100,0,3,1983,492000
6762819489,2550,9,2550,0,3,1989,490000
6762819921,2120,8,2120,0,3,1988,475226
6762820138,2030,7,2030,0,5,1942,470000
6762820139,2180,7,2180,0,4,1977,470000
6762820289,3030,8,1660,1370,4,1980,465000
6762820575,2100,8,1280,820,4,1959,457000
6762820828,1890,7,1270,620,4,1967,450000
6762820950,2800,8,2800,0,4,2003,449950
6762821082,2170,7,1630,540,4,2008,445000
6762821173,1620,8,1620,0,4,1974,442200
6762821483,1120,6,1120,0,2,1972,435000
6762821806,1720,7,1720,0,3,1994,427000
6762822084,2330,6,1600,730,3,1934,420000
6762822209,1250,7,1250,0,3,2001,418000
6762822652,1220,7,1220,0,3,1963,405000
6762822777,1770,8,1770,0,3,2001,401000
6762823396,1350,8,1050,300,3,2007,388500
6762823408,2370,8,2370,0,3,2014,387865
6762823655,2270,8,1540,730,4,1967,380000
6762823878,1090,6,980,110,1,1927,375000
6762823879,2330,8,2330,0,4,1974,375000
6762824079,1150,6,1150,0,3,1970,370000
6762824267,2200,8,2200,0,3,1987,365000
6762824268,2430,8,1900,530,3,1979,365000
6762824269,2800,7,2800,0,4,1997,365000
6762824334,2280,8,2280,0,3,1994,364250
6762824661,1850,7,1230,620,3,1981,355000
6762824662,2040,7,1470,570,3,1958,355000
6762824889,1360,8,1360,0,3,1983,350000
6762825280,1570,7,1120,450,4,1959,342000
6762825336,1540,6,1540,0,3,1977,340000
6762825876,1360,7,1360,0,4,1949,329950
6762826798,1780,7,1780,0,3,1988,309000
6762827117,1590,7,1590,0,3,2000,300000
6762827118,1300,6,1300,0,3,1927,300000
6762827842,1430,7,930,500,3,1978,284000
6762828094,860,6,860,0,3,1920,278000
6762828126,1140,7,1140,0,3,1956,277000
6762828127,2160,7,2160,0,3,1994,277000
6762828202,1300,7,1300,0,3,1962,275000
6762828411,1260,6,840,420,3,1947,270000
6762828526,1140,7,850,290,3,2008,268500
6762828537,1880,7,1810,70,3,2001,268000
6762828638,2600,8,2600,0,5,1969,265000
6762828900,1250,6,1250,0,3,1970,259875
6762829742,1240,6,1240,0,3,1953,238000
6762829827,880,7,880,0,2,1955,235000
6762829889,1820,7,1120,700,4,1987,234000
6762829976,1260,6,1260,0,3,1964,230000
6762830148,1320,7,1320,0,3,1986,225000
6762830149,1410,7,1410,0,4,1963,225000
6762830505,1060,7,1060,0,3,1955,212000
6762830523,1710,7,1710,0,4,1970,211000
6762830562,1730,7,1430,300,3,1963,210000
6762830743,1490,7,1200,290,3,1978,203000
6762831421,1470,7,1470,0,4,1945,150550
6762810057,4330,12,2090,2240,5,2008,3170000
6762810442,6085,11,6085,0,5,2000,1610000
6762810607,2720,10,2160,560,2,1953,1440000
6762810850,6160,11,4040,2120,6,2007,1280000
6762811014,3850,11,3180,670,4,1989,1200000
6762811220,2550,9,2550,0,3,2014,1100000
6762811302,3900,8,1950,1950,2,1947,1070000
6762811539,1600,7,1600,0,2,1950,995000
6762811540,4130,10,4130,0,5,2012,995000
6762811933,2950,10,2950,0,4,2012,921800
6762811978,2750,9,1840,910,5,1910,915000
6762811979,3400,11,3400,0,4,1988,915000
6762812050,3240,8,1620,1620,3,1960,902000
6762812108,3530,10,3530,0,3,1997,898000
6762812188,4090,10,4090,0,4,2005,885000
6762812663,3610,11,3290,320,4,1994,830005
6762813783,2170,8,2170,0,2,2008,740000
6762814240,1780,8,1780,0,3,1967,710000
6762814281,2130,8,1330,800,2,1972,707000
6762814443,2380,8,2380,0,2,2010,699800
6762814680,3030,9,3030,0,4,1981,682000
6762815184,2960,8,1640,1320,5,1965,654000
6762815266,1300,7,1300,0,3,1953,650000
6762815489,2790,8,1650,1140,3,1953,640000
6762815555,2840,9,2840,0,4,2013,636230
6762815789,2000,8,1040,960,3,1981,625000
6762816895,1620,7,1040,580,2,1924,577000
6762817252,2990,7,2990,0,4,2014,564950
6762817619,1650,8,1650,0,3,1901,550000
6762817799,2170,8,1420,750,4,1975,546800
6762817843,1940,8,1560,380,4,1956,545000
6762817931,1410,7,1410,0,3,1927,541000
6762818807,1770,7,1770,0,3,1967,514000
6762818961,2210,7,1510,700,3,1958,507000
6762818994,2730,8,1410,1320,4,1998,505000
6762819490,2430,7,1450,980,4,1989,490000
6762819491,1620,8,1620,0,3,2014,490000
6762819967,1870,7,1870,0,3,1978,475000
6762820593,1870,7,1060,810,3,1927,456000
6762820630,3030,8,1680,1350,4,1959,455000
6762820829,1540,7,1540,0,3,1967,450000
6762821314,1570,7,1570,0,3,1959,439995
6762821341,1250,7,1250,0,3,1965,439000
6762822995,1520,8,1520,0,3,2009,399000
6762823190,1170,7,1170,0,2,1941,393820
6762823276,1270,6,1270,0,2,1941,390000
6762823379,1400,7,1400,0,3,1962,389000
6762823656,2760,9,2760,0,5,1978,380000
6762823880,2050,7,1520,530,5,1968,375000
6762824080,2490,9,2490,0,3,2005,370000
6762824081,1540,7,1540,0,4,1961,370000
6762824436,1830,7,1830,0,3,1913,360000
6762824596,2990,8,2990,0,5,2015,357000
6762825337,1720,7,860,860,3,1957,340000
6762825980,2166,8,2166,0,5,2013,326000
6762826410,1980,7,1980,0,3,2012,317750
6762827119,2080,8,1330,750,4,1967,300000
6762827238,1810,8,1230,580,3,1980,299500
6762827373,2120,8,2120,0,4,1964,295000
6762827650,1260,7,1260,0,3,1954,289000
6762827732,610,6,610,0,2,1918,286000
6762827780,1020,6,1020,0,3,1954,285000
6762828412,1000,6,1000,0,2,1943,270000
6762828413,1870,7,1870,0,3,2009,270000
6762828639,1820,7,1820,0,4,2004,265000
6762828739,1300,7,1300,0,3,1968,263000
6762828913,1610,7,1610,0,3,1933,259000
6762828961,1730,8,1180,550,3,1978,257000
6762829033,1490,6,1490,0,3,1918,255000
6762829189,1180,7,1180,0,3,1959,250200
6762829238,1650,7,1650,0,3,2004,250000
6762830238,1360,6,1360,0,2,2004,222000
6762830435,1430,7,1030,400,4,1979,215000
6762830645,1000,6,1000,0,2,1916,207100
6762830868,1220,7,1220,0,4,1960,199000
6762831153,1010,6,1010,0,3,1977,179900
6762831579,670,6,670,0,2,1948,107000
6762831580,910,6,910,0,3,1973,107000
6762810072,4860,12,4860,0,4,1996,2950000
6762810414,2920,11,2920,0,4,1966,1650000
6762810648,4070,8,3390,680,4,2002,1400000
6762811093,4190,11,4190,0,4,1994,1160000
6762812027,2170,8,2170,0,3,1965,907000
6762812875,2870,8,1790,1080,3,1946,810000
6762812986,2760,8,1760,1000,3,1956,800000
6762813263,3250,8,1800,1450,6,1966,779000
6762813397,3630,8,1850,1780,4,1968,769000
6762813412,2270,9,2270,0,3,1988,766000
6762814521,2460,8,2460,0,4,2006,693000
6762814681,2120,7,1720,400,5,1910,682000
6762814868,4180,7,4180,0,5,2003,673200
6762815580,2470,7,2470,0,4,1987,635000
6762816691,2170,7,2170,0,3,1976,585000
6762817207,1850,9,1850,0,3,1976,565000
6762817783,1370,8,1370,0,2,2004,548000
6762817844,2080,8,2080,0,4,1991,545000
6762818197,2790,8,2790,0,4,2014,533380
6762818198,2770,9,2770,0,4,1991,533300
6762818538,1580,8,900,680,3,1946,524500
6762818926,1690,8,1690,0,3,1984,509900
6762818995,1020,7,1020,0,2,1916,505000
6762819064,1160,8,1160,0,3,1929,501000
6762819721,2110,8,1440,670,3,1978,483000
6762819791,2100,7,1220,880,3,1949,480000
6762819968,870,7,870,0,2,1946,475000
6762820096,3361,9,3361,0,4,2014,471275
6762820416,1210,8,1120,90,2,2010,461100
6762820736,1220,6,880,340,2,1938,452000
6762821377,1200,6,1200,0,3,1923,438000
6762821550,1520,7,1140,380,3,1983,434900
6762822183,1700,7,1340,360,3,1975,419000
6762822309,2240,8,1730,510,4,1981,415000
6762822310,1860,7,1490,370,3,1955,415000
6762822554,1890,7,1890,0,3,2012,409000
6762822653,2030,7,1130,900,4,1972,405000
6762822760,1520,7,1520,0,3,1986,402000
6762822846,2398,8,2398,0,4,2008,400000
6762823657,1920,7,1920,0,3,1953,380000
6762824082,1860,8,1860,0,3,1939,370000
6762824231,1445,7,1300,145,3,2005,366000
6762824270,990,7,990,0,2,1955,365000
6762824271,1410,7,1410,0,3,1959,365000
6762825424,2990,8,2990,0,5,1990,339950
6762826869,1560,8,1560,0,3,1966,306000
6762827552,2340,8,2340,0,4,1978,290000
6762828203,1490,8,1490,0,3,1978,275000
6762828310,1830,8,1830,0,3,1986,273000
6762828704,1370,7,1370,0,3,1957,264950
6762828824,2710,6,2710,0,3,1951,260000
6762828825,1670,7,1340,330,3,1985,260000
6762829551,1540,7,1440,100,3,1980,244000
6762829743,530,5,530,0,1,1941,238000
6762830058,1030,7,1030,0,3,1954,229000
6762830436,1630,7,1630,0,4,1959,215000
6762830948,1260,7,1110,150,3,1952,194000
6762815446,1040,7,870,170,3,1924,642000
6762812157,4100,10,4100,0,5,2011,890000
6762823658,1320,7,1120,200,5,1947,380000
6762825063,1950,8,1950,0,4,1994,348450
6762811221,3010,9,1890,1120,3,1931,1100000
6762812109,2580,8,2580,0,3,1964,898000
6762816755,1840,9,1840,0,4,2005,583000
6762820830,1780,8,1450,330,3,1985,450000
6762821362,1050,7,850,200,3,1949,438924
6762827623,1740,7,1390,350,3,1992,289950
6762810073,3890,10,3030,860,4,1923,2950000
6762810280,5810,10,3790,2020,4,2004,1880000
6762810608,4410,11,4410,0,4,2001,1440000
6762811552,2850,8,2490,360,4,1954,993000
6762812175,1250,7,1250,0,3,1953,888000
6762812203,2410,8,1650,760,4,1910,883000
6762812420,2380,8,2380,0,4,1925,855000
6762812722,4110,10,2570,1540,4,1979,825000
6762812960,3290,9,3290,0,4,2012,801000
6762813075,3190,10,2560,630,3,1994,795000
6762813151,2390,8,1810,580,2,1949,787500
6762813347,3890,9,3890,0,5,2004,772500
6762813628,1640,7,1440,200,3,1935,750000
6762813629,1590,8,1590,0,3,1956,750000
6762813700,2490,7,1610,880,4,1922,749500
6762813829,2790,10,1970,820,5,1991,738000
6762813962,3290,9,3290,0,4,2003,728000
6762814007,2980,10,2980,0,3,1992,725000
6762814241,1880,8,1040,840,3,1931,710000
6762814276,1750,7,1750,0,3,1929,707900
6762814365,3150,9,3150,0,4,2001,700000
6762814708,3150,9,3150,0,4,2001,680000
6762815267,2900,7,1870,1030,4,1961,650000
6762815405,2720,8,2000,720,4,1979,645000
6762815437,1770,7,1270,500,3,1929,643002
6762815581,2680,9,2680,0,3,2004,635000
6762815582,1730,9,1350,380,3,2009,635000
6762816101,2090,8,1240,850,4,1976,610000
6762816201,2430,8,1590,840,4,1968,605000
6762817033,1680,7,1680,0,3,1951,572000
6762817069,1980,7,1680,300,3,1946,570000
6762817208,2030,9,2030,0,3,1999,565000
6762817885,1690,7,1690,0,5,1914,544500
6762818034,2830,9,2830,0,3,2006,539000
6762818274,2240,7,1830,410,4,1949,530000
6762818743,2280,8,1500,780,4,1977,515000
6762819124,930,7,930,0,2,1909,500000
6762819645,1020,7,1020,0,3,1941,485000
6762819896,960,7,960,0,3,1906,477000
6762819969,2480,7,1620,860,3,1947,475000
6762820457,1140,7,1140,0,3,1942,460000
6762820694,1550,7,1550,0,3,1953,453500
6762821016,1270,7,1270,0,3,1968,447000
6762821881,1800,7,1280,520,3,1979,425000
6762822085,1770,7,1130,640,3,1952,420000
6762822252,2890,8,2890,0,4,2011,416000
6762822422,1553,8,1553,0,3,2014,412000
6762822491,1830,8,1830,0,3,1999,410000
6762822542,2430,8,2430,0,4,2003,409950
6762823223,1790,7,1220,570,3,1974,392000
6762823373,840,7,840,0,2,1948,389100
6762823492,1630,8,1630,0,3,2008,385000
6762823542,1540,7,1540,0,3,1909,384950
6762823659,1600,8,1600,0,3,1958,380000
6762823881,1330,8,1330,0,3,2004,375000
6762824568,1410,8,1360,50,3,2006,358000
6762824820,1430,6,730,700,4,1969,351000
6762824890,3380,8,2330,1050,4,1959,350000
6762825477,2700,8,2700,0,4,1992,338150
6762825680,1980,7,1220,760,5,1990,333800
6762825790,800,6,600,200,2,1929,330000
6762826278,1740,5,1740,0,5,1958,320000
6762826435,1600,7,1070,530,3,1979,316500
6762827120,1320,7,1320,0,3,2005,300000
6762827121,1310,7,1310,0,3,1962,300000
6762827333,1780,7,1780,0,4,2006,296000
6762827427,1860,8,1860,0,3,2010,294900
6762827781,1440,6,720,720,4,1954,285000
6762828158,2170,7,2170,0,4,1966,275436
6762828307,1710,7,1240,470,3,1974,273148
6762828414,1610,7,1610,0,3,1927,270000
6762828475,1480,7,1480,0,3,1996,269950
6762828507,770,6,770,0,2,1953,269000
6762828779,750,6,750,0,2,1943,261000
6762829481,1990,7,1440,550,3,1988,245000
6762829828,1610,6,1610,0,4,1947,235000
6762829977,1120,7,1120,0,3,1965,230000
6762830650,1520,7,1520,0,3,2005,207000
6762831307,1220,6,1220,0,4,1944,165000
6762831583,840,6,840,0,3,1959,105000
6762810149,4370,10,3670,700,4,1907,2350000
6762810721,5370,11,5370,0,4,1990,1350000
6762810982,4330,11,4330,0,4,1997,1210000
6762811148,3370,10,3370,0,4,1999,1140000
6762811525,3030,9,2530,500,4,1947,998000
6762811965,3170,9,3170,0,5,2014,919950
6762812612,2230,9,2230,0,3,1996,836500
6762812846,3320,10,3320,0,4,1999,813000
6762813154,2530,7,1540,990,4,1925,785950
6762813264,1990,8,1330,660,3,1941,779000
6762813968,2180,8,1520,660,3,1939,727000
6762814165,2970,9,2970,0,4,1993,715000
6762814242,2710,8,1690,1020,4,1995,710000
6762814298,3150,9,3150,0,4,2001,705000
6762814366,2600,8,1300,1300,3,1968,700000
6762814498,3940,9,3940,0,5,2007,695000
6762814562,1600,7,1030,570,3,1941,690000
6762814985,3770,9,3770,0,4,2003,665000
6762814986,2330,10,2330,0,3,1996,665000
6762815901,1458,8,950,508,3,2014,620000
6762816004,1980,8,1890,90,3,2009,615000
6762816202,2010,9,2010,0,3,2008,605000
6762816319,2100,8,2100,0,3,1979,600000
6762816455,2470,7,1140,1330,2,1916,597000
6762816543,1690,7,1140,550,4,1912,591500
6762816623,2940,9,1710,1230,3,1996,589000
6762816624,2250,8,2250,0,3,2004,589000
6762816692,3110,9,3110,0,4,2005,585000
6762816896,1740,7,970,770,3,1953,577000
6762817444,1220,7,1220,0,2,1961,555950
6762817766,1510,7,1510,0,2,1921,549000
6762817845,1280,8,1280,0,3,2009,545000
6762817969,2520,9,2520,0,3,1990,540000
6762817970,1230,9,1050,180,2,2009,540000
6762818035,2350,7,2350,0,3,1993,539000
6762818141,1510,7,1510,0,2,1939,535000
6762818275,1900,8,1900,0,2,2006,530000
6762818566,1430,8,1340,90,2,2005,522500
6762818674,2160,8,2160,0,4,1983,518000
6762818808,2260,7,1450,810,3,1962,514000
6762819240,1360,7,1360,0,3,1955,499950
6762819319,2060,8,1400,660,3,2007,497000
6762819367,1920,7,1060,860,2,1937,495000
6762819753,1290,8,1290,0,2,2007,481000
6762819792,2270,7,2270,0,3,1999,480000
6762819897,1380,7,1080,300,4,1928,477000
6762819970,1420,7,1420,0,4,1950,475000
6762819971,1480,7,1480,0,3,1959,475000
6762820233,1420,8,1420,0,3,2008,467000
6762820458,2080,8,1590,490,3,1979,460000
6762820976,1690,7,1690,0,3,2005,449000
6762821187,2360,7,2360,0,3,1998,441500
6762821484,1510,7,1070,440,4,1970,435000
6762821882,1550,6,1550,0,3,1926,425000
6762822086,930,7,930,0,2,1953,420000
6762822311,880,7,880,0,2,1910,415000
6762822492,3040,9,3040,0,3,2005,410000
6762822569,810,6,810,0,2,1948,408000
6762822580,2740,7,2210,530,5,1962,407500
6762822590,1430,8,1430,0,3,2005,407000
6762822847,1180,7,1180,0,3,1987,400000
6762823277,1000,7,1000,0,3,1947,390000
6762823596,1450,7,1450,0,3,2009,382000
6762823660,1450,8,1100,350,3,2009,380000
6762823882,1010,7,1010,0,2,1950,375000
6762824437,2340,8,2340,0,4,1990,360000
6762825165,1870,8,1870,0,3,2003,345000
6762825166,1620,7,1620,0,3,2001,345000
6762825338,2530,7,2530,0,4,1974,340000
6762825791,720,5,720,0,2,1943,330000
6762825936,2020,7,2020,0,3,1994,328000
6762826230,1800,8,1800,0,4,2004,321000
6762826402,1410,7,1410,0,3,1988,318000
6762826426,2120,7,2120,0,6,1979,317000
6762826708,570,5,570,0,1,1918,310000
6762827300,2110,8,1530,580,3,1980,298700
6762827334,1360,7,960,400,3,1971,296000
6762827343,1590,6,1290,300,3,1933,295500
6762828640,1730,6,1730,0,4,1920,265000
6762828926,2300,6,1150,1150,4,1962,258750
6762828936,1730,8,1730,0,3,1994,258000
6762828962,1450,7,1450,0,3,1910,257000
6762829338,1100,7,1100,0,3,1960,249900
6762829769,1490,7,1490,0,3,2005,237000
6762830150,1790,6,1790,0,3,1937,225000
6762810048,6200,11,4440,1760,5,1989,3300000
6762810395,4490,12,4490,0,4,1998,1680000
6762810900,3750,9,2750,1000,6,1936,1250000
6762811358,2330,10,1870,460,2,1927,1050000
6762811603,3250,8,2360,890,4,1944,980000
6762812179,3830,9,2440,1390,6,1962,887000
6762812604,3760,9,2360,1400,6,1967,838300
6762812904,1750,8,1010,740,3,1914,808250
6762812957,2130,8,2130,0,4,1961,802000
6762813373,2900,10,1490,1410,3,1987,770000
6762813426,3300,9,1720,1580,4,1971,765000
6762813858,2100,8,1340,760,4,1955,735000
6762814961,2860,9,2860,0,4,2000,666500
6762814962,3000,7,2110,890,3,1918,666000
6762815218,1940,7,970,970,3,1940,651000
6762815406,1550,8,1550,0,4,1958,645000
6762815790,2240,7,1650,590,3,1901,625000
6762815846,1540,7,1540,0,4,1902,624000
6762815970,3560,8,2810,750,5,2013,616950
6762816172,1770,8,1370,400,4,1967,606150
6762816950,2980,9,2230,750,5,1976,575000
6762817144,3010,9,3010,0,4,2000,568500
6762817209,2700,6,1950,750,5,1948,565000
6762817343,1480,8,1480,0,3,1980,560000
6762817464,2160,8,2160,0,3,1988,555000
6762817620,2670,7,2670,0,4,1916,550000
6762817971,3510,8,2750,760,4,2010,540000
6762817972,2710,7,2710,0,4,2011,540000
6762818142,1330,7,1330,0,3,1977,535000
6762818276,1680,7,1680,0,3,1967,530000
6762818277,3080,8,1740,1340,3,1965,530000
6762818358,2140,7,1200,940,5,1962,528000
6762818381,2330,8,2330,0,4,1987,527000
6762818744,2030,7,1530,500,4,1953,515000
6762818962,1180,7,1180,0,3,1950,507000
6762818996,1830,7,1010,820,3,1981,505000
6762819027,1820,8,1640,180,3,1998,504500
6762819274,1610,8,1610,0,3,2000,499000
6762820197,1820,8,1820,0,3,1978,469000
6762820831,3931,10,2650,1281,5,2014,450000
6762821250,850,6,850,0,1,1940,440000
6762821317,1540,8,1540,0,4,2014,439990
6762821342,2230,8,1450,780,3,1928,439000
6762821378,1970,8,1970,0,4,2004,438000
6762821551,1520,7,1520,0,3,1977,434900
6762821561,1540,6,1040,500,3,1919,433500
6762822025,1300,7,1300,0,3,1988,422500
6762822602,1380,7,1380,0,3,1968,406430
6762823562,1180,7,1180,0,3,1963,383001
6762823883,1260,7,1260,0,3,1947,375000
6762823884,800,5,800,0,1,1950,375000
6762823999,1310,7,1310,0,3,1976,373000
6762824186,2610,7,1360,1250,4,1965,368000
6762824272,1484,7,1484,0,3,2003,365000
6762824375,1420,8,1160,260,3,2004,362000
6762824663,1445,7,1300,145,3,2005,355000
6762824891,2470,8,2230,240,3,1984,350000
6762824892,1240,7,1240,0,3,1959,350000
6762825592,1030,7,765,265,2,2006,335000
6762826038,1400,6,1400,0,4,1948,325000
6762826039,730,7,730,0,1,2009,325000
6762826203,1160,7,1160,0,3,1968,322500
6762826709,2440,7,2440,0,4,1999,310000
6762827374,1760,7,1760,0,3,1998,295000
6762827782,1440,7,1040,400,3,1953,285000
6762828111,2350,7,2350,0,5,1961,277554
6762828204,1950,7,1010,940,3,1956,275000
6762828585,1650,7,1650,0,3,1988,266750
6762828724,2300,8,2300,0,4,1978,263850
6762829638,1310,7,1310,0,3,1990,240000
6762829978,1920,7,1160,760,5,1961,230000
6762829979,1310,7,1310,0,3,1987,230000
6762830059,1760,7,1760,0,3,1943,229000
6762830344,1370,7,1370,0,4,1961,219000
6762830769,1220,7,1220,0,3,1972,201000
6762831066,720,6,720,0,1,1908,185000
6762831251,480,5,480,0,1,1922,170000
6762831435,1450,7,1450,0,3,1952,150000
6762831592,790,6,790,0,2,1944,100000
6762810476,4220,11,3420,800,5,1991,1580000
6762810541,3990,9,2870,1120,3,1922,1500000
6762810741,2730,9,1940,790,3,1963,1340000
6762811222,3410,8,1710,1700,4,1958,1100000
6762811422,3780,11,3780,0,4,2002,1030000
6762811526,3770,10,3770,0,4,1992,998000
6762811527,3710,10,2910,800,3,1978,998000
6762811631,3420,10,3420,0,4,2000,975000
6762811765,2330,7,2330,0,6,1920,950000
6762811866,4150,10,4150,0,5,1988,930800
6762812362,2800,9,1400,1400,4,1924,863000
6762812440,3480,9,2360,1120,4,2000,852500
6762812627,3130,9,2140,990,4,1993,835000
6762812809,3230,10,3230,0,3,1999,817500
6762813275,2680,7,1380,1300,4,1962,777000
6762813686,3060,10,3060,0,5,1989,749999
6762813784,2050,9,2050,0,4,1922,740000
6762814367,2410,10,2410,0,3,1989,700000
6762814499,2380,7,1690,690,3,1927,695000
6762814500,3080,8,2080,1000,3,1984,695000
6762814987,2160,7,1320,840,4,1921,665000
6762815108,1540,8,1540,0,3,1907,659000
6762815158,2370,9,1630,740,4,1984,655000
6762815268,2160,7,1080,1080,4,1940,650000
6762815358,1810,8,1810,0,3,1913,649000
6762815434,1650,8,1650,0,3,1945,643500
6762815791,1580,8,1580,0,3,1970,625000
6762815844,3030,8,1670,1360,6,1980,624500
6762816744,1720,7,1170,550,3,1978,583500
6762817131,2800,8,1700,1100,4,1971,569500
6762817210,1700,7,850,850,3,1969,565000
6762817292,2400,8,2400,0,3,1983,562000
6762817543,1330,8,1120,210,3,2005,552100
6762817973,1280,8,1280,0,3,2009,540000
6762818449,1380,7,1080,300,3,1955,525000
6762818450,2420,7,2420,0,4,1967,525000
6762818660,2620,8,1350,1270,5,1979,519000
6762818942,1520,7,1000,520,4,1955,508450
6762819125,2840,9,2840,0,4,1994,500000
6762819126,2010,8,2010,0,3,1985,500000
6762819646,3110,9,3110,0,3,1990,485000
6762819728,2940,8,2940,0,6,1966,482500
6762820459,1860,8,1470,390,3,1954,460000
6762820460,1420,7,1420,0,3,1960,460000
6762820594,1700,7,1080,620,4,1977,456000
6762820631,3470,8,2790,680,5,1978,455000
6762820688,2530,8,1530,1000,3,1991,454000
6762821004,2425,9,2425,0,4,2013,447500
6762821394,2100,8,2100,0,3,1983,437500
6762821769,2650,9,2650,0,4,2000,428400
6762822167,1450,8,1160,290,3,2006,419700
6762822654,720,6,720,0,2,1942,405000
6762822655,1850,8,1850,0,4,1997,405000
6762822713,2120,8,2120,0,4,1993,403950
6762822848,3320,8,1660,1660,6,1977,400000
6762823123,1500,7,870,630,3,2003,395000
6762823380,1720,7,1720,0,3,2005,389000
6762823568,1830,7,1060,770,4,1962,383000
6762823614,1340,8,1340,0,2,2004,381000
6762823885,1330,6,710,620,3,1936,375000
6762823886,1450,7,1450,0,4,1950,375000
6762823887,1680,7,1680,0,4,1948,375000
6762823987,1100,9,1100,0,2,2009,374000
6762824083,2720,9,2720,0,4,1992,370000
6762825167,860,9,860,0,2,2009,345000
6762825339,980,7,980,0,3,1946,340000
6762826843,1410,7,1410,0,3,1982,307000
6762826870,910,7,910,0,3,1955,306000
6762826996,1981,8,1981,0,3,2010,303700
6762827224,2200,8,2200,0,4,2003,299900
6762827375,1250,6,1250,0,3,1971,295000
6762827685,2240,7,1310,930,4,1979,287500
6762827950,910,6,910,0,2,1942,280000
6762828205,2000,7,1010,990,4,1975,275000
6762828206,1380,7,1380,0,3,1971,275000
6762828826,1200,6,800,400,3,1950,260000
6762828827,1440,7,1440,0,3,2006,260000
6762829171,1810,7,1240,570,3,1977,251700
6762829482,2190,7,2190,0,4,1986,245000
6762829902,1580,6,1580,0,3,1957,233500
6762829919,1240,6,960,280,2,1922,232000
6762830437,1700,7,1700,0,4,1997,215000
6762830563,1250,7,1250,0,3,1969,210000
6762830800,790,6,790,0,2,1944,200000
6762831128,770,7,770,0,2,1947,180000
6762831533,920,6,920,0,3,1960,125000
6762814047,1560,7,1560,0,2,1942,724000
6762826279,1110,8,1110,0,2,2000,320000
6762829034,940,6,940,0,2,1941,255000
6762829376,2090,7,2090,0,3,1948,248500
6762830991,630,6,630,0,2,1943,190000
6762822773,1790,7,1260,530,4,1954,401500
6762823731,1800,8,1800,0,3,2011,379900
6762810930,3330,9,2330,1000,4,1928,1240000
6762811445,4180,10,3160,1020,5,1990,1020000
6762811491,2230,8,1630,600,4,1906,1000000
6762811576,4040,11,4040,0,4,1987,988000
6762811930,3600,9,3600,0,4,2014,923990
6762811946,3140,8,1570,1570,4,1961,920000
6762812037,3300,7,2390,910,4,1946,905000
6762812337,2520,8,2520,0,4,1906,865000
6762812640,3630,9,2790,840,5,2014,834950
6762812644,2780,9,1670,1110,3,1948,834500
6762813630,2860,8,2380,480,5,1902,750000
6762814623,1490,8,1490,0,3,1958,685650
6762814784,2920,9,2920,0,3,2013,675900
6762815137,3060,9,1810,1250,4,1982,657000
6762815583,1530,7,1020,510,3,1948,635000
6762815675,2540,9,2540,0,4,1999,630000
6762816005,1860,7,930,930,3,1983,615000
6762816006,2530,9,2530,0,3,1985,615000
6762816567,1530,7,1530,0,2,1920,590000
6762816772,2600,7,2600,0,3,2004,581000
6762816812,1990,6,1430,560,2,1944,580000
6762816951,1890,8,1890,0,3,1968,575000
6762817070,2580,9,1390,1190,3,1986,570000
6762817621,2120,8,1450,670,4,1961,550000
6762817622,2360,8,1760,600,4,1949,550000
6762817623,2230,8,1460,770,3,1977,550000
6762818036,2170,7,1280,890,3,1923,539000
6762818087,1720,8,1470,250,4,2000,536500
6762819275,1260,7,780,480,3,1944,499000
6762819442,2550,7,2550,0,4,2007,492000
6762819647,2430,7,2430,0,3,2011,485000
6762819972,1690,7,1690,0,3,2004,475000
6762820113,2320,8,2320,0,4,1986,470101
6762821485,1470,7,930,540,3,1985,435000
6762821883,1630,7,1100,530,3,1974,425000
6762822009,2070,8,2070,0,3,1999,423700
6762822312,2520,8,1680,840,4,1970,415000
6762822761,1510,7,1510,0,4,1957,402000
6762823744,2120,7,2120,0,4,1985,379500
6762824376,1290,7,1290,0,3,1956,362000
6762824438,2060,7,1560,500,1,1927,360000
6762824539,1680,8,1680,0,4,1991,359000
6762824805,2470,8,2470,0,4,2004,352000
6762824893,1010,7,1010,0,3,1953,350000
6762825250,1120,7,1120,0,3,1972,343000
6762825340,2060,7,1300,760,4,1960,340000
6762825593,1360,5,1360,0,2,1937,335000
6762825949,1770,8,1330,440,3,1981,327500
6762826187,2100,7,2100,0,3,1963,323000
6762826663,3340,8,3340,0,4,1973,311000
6762827007,1100,6,1100,0,2,1943,303000
6762827122,1010,7,1010,0,3,1957,300000
6762827123,2050,7,1300,750,4,1967,300000
6762827195,1870,8,1870,0,3,1989,299990
6762827783,1160,7,1160,0,3,1992,285000
6762827784,1890,7,1890,0,3,2005,285000
6762827897,1280,7,1280,0,3,2003,281000
6762828293,1440,7,990,450,3,1981,274000
6762828415,1750,7,1350,400,3,1965,270000
6762828416,720,7,720,0,1,1911,270000
6762828538,1250,7,1250,0,3,1987,268000
6762828559,960,6,960,0,2,1951,267500
6762828577,1030,7,1030,0,3,1952,267000
6762828641,1410,7,1410,0,3,2006,265000
6762828828,1750,8,1750,0,3,1983,260000
6762828963,770,6,770,0,2,1950,257000
6762829239,1140,7,1140,0,3,1998,250000
6762829572,1450,7,1450,0,3,1981,243000
6762829639,1040,7,1040,0,3,1948,240000
6762829756,1480,7,1480,0,3,1980,237500
6762829757,810,6,810,0,2,1949,237500
6762830564,1200,6,1200,0,3,1977,210000
6762830801,1010,7,1010,0,3,1955,200000
6762831266,840,6,840,0,3,1961,169950
6762810396,4790,12,4790,0,4,1999,1680000
6762810542,5020,12,5020,0,4,1998,1500000
6762810722,3030,9,2700,330,4,1925,1350000
6762810786,3200,8,1600,1600,5,1959,1310000
6762811149,3080,9,1700,1380,4,1941,1140000
6762811223,3770,10,2940,830,4,2006,1100000
6762811560,1810,9,930,880,3,1983,990000
6762811632,2720,10,2720,0,4,1989,975000
6762811766,2980,10,2640,340,4,1981,950000
6762811910,3110,9,3110,0,4,1989,925000
6762812110,2700,9,2700,0,5,1987,898000
6762812130,1700,8,1260,440,2,1950,895000
6762812670,3820,9,2870,950,3,1999,830000
6762812804,4790,9,3110,1680,5,2005,818500
6762812850,2750,10,2750,0,4,1991,812500
6762813064,2110,8,2110,0,4,2001,796000
6762813190,1590,7,990,600,4,1900,783200
6762813193,2930,9,2930,0,4,2005,782500
6762813494,2990,9,2210,780,4,2003,760000
6762813495,2190,7,1540,650,3,1957,760000
6762813826,3360,9,3360,0,5,2014,738515
6762813900,2630,9,2630,0,3,2006,731781
6762814123,2070,8,2070,0,3,2001,718000
6762814464,2640,9,2260,380,3,1978,698000
6762814471,3160,8,3160,0,4,2005,697000
6762814591,2330,7,1220,1110,2,1953,689000
6762814988,2650,8,2230,420,4,2011,665000
6762815068,2650,9,2650,0,3,2005,660000
6762815159,3420,9,3420,0,4,2004,655000
6762815373,2740,9,2740,0,4,1989,648000
6762815902,1840,8,1840,0,4,2000,620000
6762816273,3110,8,3110,0,4,2014,600600
6762817071,2910,7,1530,1380,3,1967,570000
6762817124,3380,8,3380,0,5,2014,569950
6762817398,2200,7,1440,760,5,1987,559900
6762817624,1730,7,1250,480,3,1947,550000
6762817784,3420,10,2330,1090,4,2008,548000
6762817880,2710,7,2710,0,4,2009,544999
6762818037,1790,7,1410,380,3,1978,539000
6762818143,2460,7,1230,1230,6,1913,535000
6762818382,2830,9,2830,0,4,2000,527000
6762818609,1340,7,1060,280,2,2006,520000
6762819368,2020,7,1010,1010,4,1968,495000
6762820074,1650,8,1650,0,3,1996,472500
6762820290,3210,8,2410,800,5,2011,465000
6762820388,2190,8,2190,0,3,1991,463000
6762820461,1600,7,1600,0,3,1979,460000
6762820595,2130,8,2130,0,3,2013,456000
6762820832,3150,8,3150,0,7,2013,450000
6762821042,1300,7,1300,0,3,1968,445950
6762821412,2190,7,1390,800,5,1961,437000
6762821580,1340,8,1340,0,3,1984,432500
6762821754,1080,7,1080,0,2,1922,429000
6762821884,2500,8,1300,1200,3,1957,425000
6762821885,1970,7,1680,290,3,1955,425000
6762822087,1140,7,1140,0,3,1982,420000
6762822656,1760,7,1160,600,3,1956,405000
6762822952,2760,7,1380,1380,5,1964,399950
6762823050,1300,7,1300,0,3,1969,397500
6762823124,1440,7,1440,0,4,1946,395000
6762823195,2140,8,2140,0,3,1987,393000
6762823493,2700,7,1350,1350,6,1969,385000
6762823661,2110,8,1590,520,2,1975,380000
6762823888,3140,8,2080,1060,4,1971,375000
6762823966,2540,8,1290,1250,3,1964,374950
6762823976,3135,9,3135,0,4,2005,374500
6762824508,1570,7,1040,530,3,1979,359950
6762824894,2370,7,2370,0,3,2002,350000
6762825098,940,7,940,0,3,1968,347000
6762825222,1870,8,1320,550,3,1978,344950
6762825792,1590,7,1040,550,4,1967,330000
6762826040,1870,7,1250,620,3,1994,325000
6762826710,1990,7,1990,0,3,1972,310000
6762827049,1030,7,1030,0,3,1967,301000
6762827124,1830,7,1430,400,3,1966,300000
6762827376,1050,6,1050,0,2,1925,295000
6762827553,1700,7,1700,0,3,1986,290000
6762827651,1970,6,1970,0,3,1968,289000
6762827951,1260,6,1100,160,2,1947,280000
6762828061,1530,7,970,560,3,1952,279000
6762828339,2550,7,1560,990,5,1959,272000
6762828417,1240,7,1240,0,3,1972,270000
6762829872,1430,7,1430,0,3,1994,234950
6762829890,1010,7,1010,0,3,1968,234000
6762830033,920,6,920,0,2,1944,229950
6762830230,860,5,860,0,2,1942,222900
6762830239,1310,7,1310,0,3,1968,222000
6762830280,1260,7,1260,0,5,1918,220000
6762830478,1020,6,1020,0,3,1900,214000
6762830700,1010,7,1010,0,3,1968,205000
6762830857,1750,5,1750,0,4,1943,199500
6762831129,1470,6,1470,0,4,1924,180000
6762831371,1520,7,1520,0,3,1985,158000
6762831400,1040,6,1040,0,2,1949,154000
6762810833,3210,10,2290,920,5,1917,1290000
6762810952,3732,10,2932,800,5,2001,1230000
6762811015,5180,11,2610,2570,5,1993,1200000
6762812070,2980,8,1590,1390,3,1941,900000
6762812260,1670,8,1670,0,4,1906,875000
6762812306,3090,7,3090,0,4,1990,870000
6762812876,3340,9,3340,0,4,2014,810000
6762813735,2650,11,2650,0,4,1994,745000
6762813914,1728,9,1728,0,2,2012,730000
6762814084,3410,8,3410,0,3,1993,720000
6762814223,2040,8,1540,500,3,1917,710500
6762815584,2660,7,1380,1280,4,1949,635000
6762815903,1780,8,1570,210,3,2007,620000
6762815977,3920,9,3030,890,5,2014,616200
6762816050,2050,7,1580,470,3,1927,613200
6762816568,2660,9,2660,0,4,1993,590000
6762816693,2400,7,2400,0,4,1962,585000
6762816694,2370,8,1660,710,4,1975,585000
6762816813,2570,8,2570,0,4,1980,580000
6762816866,1280,8,1080,200,2,2009,579000
6762817173,1730,8,1730,0,3,2014,566950
6762817567,1720,7,1720,0,3,1966,550388
6762817733,1260,7,1000,260,2,1940,549950
6762817734,2080,8,1430,650,3,1974,549950
6762818144,2200,7,1330,870,4,1979,535000
6762818391,2970,8,2970,0,4,1983,526000
6762818451,2870,8,2870,0,3,1948,525000
6762818452,1510,7,880,630,2,1924,525000
6762818745,1730,8,1730,0,4,1965,515000
6762818866,1610,7,1210,400,3,1984,510000
6762818967,1890,7,1500,390,4,1978,506500
6762819305,2360,7,1780,580,3,1983,498000
6762819492,1510,8,1510,0,3,1984,490000
6762819648,1910,7,1020,890,5,1968,485000
6762819649,2540,8,1820,720,3,1976,485000
6762820064,1510,8,1510,0,2,2005,473000
6762820140,3860,7,3860,0,5,2003,470000
6762820399,1540,7,1540,0,4,1905,462500
6762820833,1290,7,1150,140,3,1968,450000
6762821083,2360,8,2360,0,4,2000,445000
6762821188,2420,8,1780,640,3,1993,441500
6762821251,1550,7,1210,340,3,1981,440000
6762821619,1000,7,1000,0,2,1918,431000
6762821886,2440,7,2440,0,4,2007,425000
6762822184,3310,9,3310,0,3,2004,419000
6762822185,4340,7,2550,1790,7,1986,419000
6762822313,1230,6,830,400,1,1924,415000
6762822314,1620,7,1620,0,4,1927,415000
6762822657,3672,9,3006,666,5,2006,405000
6762823095,2738,8,2738,0,5,2014,395950
6762823278,1150,7,770,380,2,1923,390000
6762823365,1710,6,1710,0,4,1942,389900
6762823606,2430,8,2430,0,4,2003,381500
6762823662,1540,7,1540,0,3,1968,380000
6762823889,1630,7,1630,0,3,1988,375000
6762823890,1900,8,1900,0,4,1978,375000
6762823891,2800,9,2800,0,4,2006,375000
6762823988,1140,6,980,160,2,1920,374000
6762824187,2080,7,2080,0,3,2004,368000
6762824664,1180,7,1180,0,3,1977,355000
6762824759,860,7,860,0,2,1949,353000
6762824760,2210,8,2210,0,4,2009,353000
6762825085,2540,8,2540,0,3,2010,347500
6762825341,2440,8,2440,0,5,2003,340000
6762825670,2310,8,2310,0,4,1998,334000
6762825793,1340,6,1170,170,3,1907,330000
6762827952,2140,7,2140,0,3,1979,280000
6762828207,1140,5,1140,0,2,1935,275000
6762828208,1190,7,1190,0,3,1943,275000
6762828323,1800,7,1330,470,4,1966,272750
6762828642,2920,7,1800,1120,5,1911,265000
6762828715,1420,6,1420,0,3,1944,264250
6762828829,1320,7,1320,0,3,1954,260000
6762828830,1690,7,1690,0,3,1959,260000
6762829176,840,6,840,0,2,1949,251000
6762829325,1790,7,1480,310,3,2006,249950
6762829483,1050,7,1050,0,2,1950,245000
6762829579,1020,6,1020,0,3,1941,242500
6762829580,940,6,940,0,3,1959,242500
6762829829,1500,6,1500,0,5,1966,235000
6762830393,1020,6,1020,0,3,1971,216500
6762830438,1190,7,1190,0,3,1968,215000
6762830600,1170,7,1170,0,3,1948,209977
6762830701,1410,7,1410,0,3,1985,205000
6762830869,1050,7,1050,0,3,1968,199000
6762831509,900,6,900,0,3,1978,133400
6762810034,5510,13,4910,600,3,1997,3800000
6762810038,4830,11,4830,0,4,1990,3640000
6762810265,3690,12,3690,0,2,1989,1900000
6762810286,4460,10,3460,1000,6,1930,1870000
6762810292,2910,9,1830,1080,4,1914,1850000
6762810558,3620,10,2790,830,5,1958,1490000
6762810617,3380,10,3380,0,4,1966,1430000
6762810672,2490,8,1790,700,3,1911,1390000
6762810864,3640,9,1960,1680,4,1913,1270000
6762810983,5400,11,5400,0,3,1997,1210000
6762811119,3160,11,2160,1000,3,1991,1150000
6762811492,2990,9,2000,990,4,1925,1000000
6762811794,2490,8,1240,1250,4,1958,949000
6762812382,3380,9,1690,1690,4,1952,860000
6762812535,4450,9,3650,800,5,2014,845950
6762812579,2840,10,2840,0,4,1986,840000
6762812723,1830,7,1230,600,2,1926,825000
6762812909,2190,8,1410,780,4,1928,808000
6762812928,3320,10,3320,0,4,1991,805000
6762813306,2540,10,2540,0,4,1984,775000
6762813307,2620,9,2620,0,3,1998,775000
6762813817,2310,8,2310,0,3,2010,739000
6762813859,3200,9,2500,700,4,2013,735000
6762813915,2040,9,2040,0,3,1977,730000
6762814221,2095,8,1295,800,4,1910,711000
6762814222,2880,10,2880,0,3,1992,710800
6762814243,1210,7,1000,210,2,1942,710000
6762814452,2550,9,2550,0,4,1988,699000
6762814453,2010,9,2010,0,3,1999,699000
6762814709,1450,9,1450,0,2,2014,680000
6762814710,2970,9,2970,0,5,2000,680000
6762814989,1800,8,1800,0,3,1972,665000
6762815030,2450,7,1340,1110,6,1957,662500
6762815269,1910,8,1300,610,4,1954,650000
6762815345,2150,9,2150,0,3,1979,649950
6762815863,2290,8,2290,0,3,1983,622500
6762815904,2520,9,1590,930,3,2005,620000
6762815960,2340,9,2340,0,3,1998,618000
6762816320,3150,9,1620,1530,5,1974,600000
6762816391,2290,8,2290,0,4,1988,599950
6762817072,2710,9,2710,0,4,2006,570000
6762817404,2010,8,2010,0,3,1989,559000
6762817465,1760,7,1760,0,4,1988,555000
6762817466,3760,10,2640,1120,3,1979,555000
6762817548,1150,7,1050,100,2,1924,552000
6762817625,1360,7,1360,0,3,1934,550000
6762817730,2970,8,2260,710,4,2014,549995
6762817731,2660,8,1920,740,4,2014,549995
6762818278,2120,8,2120,0,3,1967,530000
6762818823,1540,7,1540,0,4,1950,512500
6762819241,1320,8,990,330,2,2014,499950
6762819973,2110,8,2110,0,4,1974,475000
6762820084,2180,8,1090,1090,3,1954,472000
6762820737,2300,8,1700,600,3,2007,452000
6762821084,2930,7,1750,1180,5,1951,445000
6762821085,2170,7,2170,0,4,1989,445000
6762821252,2100,7,1080,1020,3,1957,440000
6762821253,2990,9,2990,0,4,2011,440000
6762821369,1340,7,1340,0,2,1953,438400
6762821887,1960,7,1960,0,3,2003,425000
6762822017,2660,8,2660,0,4,2004,423000
6762822088,1440,6,720,720,3,1922,420000
6762822315,910,7,910,0,2,1904,415000
6762822493,2150,8,2150,0,4,1976,410000
6762822849,1190,8,1050,140,3,2008,400000
6762823085,2840,7,1420,1420,5,1960,396000
6762823242,1460,7,960,500,2,1966,390500
6762823279,860,7,860,0,2,1909,390000
6762823549,1810,8,1810,0,3,2014,384205
6762824038,1960,6,1960,0,4,1979,371000
6762824597,2460,7,2460,0,3,1955,357000
6762825342,1750,7,1750,0,5,1956,340000
6762825533,1260,8,1260,0,3,2004,336000
6762825594,1510,7,1510,0,2,1923,335000
6762826175,1070,7,1070,0,2,1955,324000
6762826491,1210,7,1210,0,3,1958,315000
6762826919,2130,7,2130,0,4,1966,305000
6762827204,1780,7,1780,0,3,2011,299950
6762827554,960,6,960,0,2,1918,290000
6762827674,1610,7,1610,0,4,2010,288000
6762827733,1820,7,1820,0,4,1989,286000
6762827785,1050,7,1050,0,2,2005,285000
6762829240,1610,7,1610,0,3,1994,250000
6762829387,2120,7,1220,900,3,1984,248000
6762830089,1120,6,1120,0,4,1971,227000
6762830151,720,6,720,0,2,1947,225000
6762830778,2040,8,1340,700,3,1968,200126
6762831196,1300,6,1300,0,4,1947,175000
6762810266,6510,11,3250,3260,5,1980,1900000
6762810984,4150,10,4150,0,5,2014,1210000
6762811399,4770,11,3070,1700,5,1973,1040000
6762811423,2830,9,1910,920,4,1912,1030000
6762811657,3780,10,3780,0,4,2001,970000
6762812131,2640,8,1730,910,4,1925,895000
6762812435,2820,9,1770,1050,3,1985,853505
6762812479,3300,9,3300,0,3,1994,850000
6762813042,2140,8,2140,0,3,1959,799000
6762813556,3680,9,3680,0,3,1994,755000
6762814085,2040,7,1360,680,3,1924,720000
6762814563,1930,7,1930,0,4,1920,690000
6762814711,2620,8,1830,790,3,1977,680000
6762814818,2280,8,1520,760,4,1931,675000
6762814858,2650,8,2230,420,4,2011,674950
6762815270,1510,9,1330,180,3,2001,650000
6762815271,2690,8,2130,560,3,1957,650000
6762816695,2330,9,2330,0,4,1989,585000
6762817120,2650,8,2650,0,4,2014,569995
6762817308,3370,9,3370,0,5,2006,561000
6762817344,2780,9,2780,0,3,1993,560000
6762817626,2030,9,1730,300,4,1939,550000
6762818145,2640,9,2640,0,3,2012,535000
6762818575,1150,7,1150,0,3,1952,522000
6762818824,2200,8,2200,0,4,1975,512500
6762818867,1920,7,1340,580,3,1962,510000
6762818868,2300,9,2300,0,3,1995,510000
6762818933,2130,7,1570,560,3,1913,509000
6762819127,1550,8,1550,0,3,1918,500000
6762819242,1340,7,1090,250,3,1941,499950
6762819332,3090,9,2020,1070,3,1995,496000
6762819493,1630,7,1230,400,3,1983,490000
6762819554,2400,9,2400,0,3,2002,489950
6762819888,2090,7,2090,0,2,1918,477500
6762820141,2280,8,2280,0,3,2004,470000
6762820462,1400,8,700,700,3,1908,460000
6762820834,3236,10,3236,0,4,2005,450000
6762820977,1460,8,1160,300,2,2008,449000
6762821254,2400,8,2400,0,4,2002,440000
6762821486,1700,7,850,850,4,1940,435000
6762821487,1730,8,1730,0,3,1996,435000
6762821488,901,7,901,0,2,2001,435000
6762822253,1710,8,1510,200,3,2004,416000
6762822570,1970,7,1590,380,3,1976,408000
6762824895,1070,8,1070,0,2,2003,350000
6762825015,2240,8,2240,0,3,1999,349950
6762825236,1300,8,1300,0,2,2005,344000
6762825343,2360,8,2360,0,4,1992,340000
6762825344,1400,7,1200,200,3,1921,340000
6762826147,1210,7,1210,0,3,1941,324950
6762827377,1660,7,1150,510,3,1999,295000
6762827953,1610,7,1610,0,3,1977,280000
6762828085,800,6,800,0,2,1936,278750
6762828643,1400,7,1110,290,3,1957,265000
6762829241,670,6,670,0,2,1943,250000
6762829242,2040,7,2040,0,4,1994,250000
6762829360,1090,7,1090,0,2,1990,249000
6762829830,1020,6,780,240,3,1948,235000
6762830870,1160,7,1160,0,4,1975,199000
6762830901,880,7,880,0,3,1978,196000
6762811767,3100,9,3100,0,4,1962,950000
6762817073,1270,7,1270,0,3,1911,570000
6762821334,1360,7,1360,0,4,1950,439500
6762824084,1690,7,1430,260,3,1952,370000
6762827378,1560,8,1560,0,2,1967,295000
6762814675,2620,9,2620,0,4,1990,683000
6762816321,2230,7,1180,1050,4,1981,600000
6762817345,1680,8,1680,0,2,2008,560000
6762825345,1900,7,1900,0,4,1973,340000
6762810331,5440,12,5440,0,4,1990,1770000
6762810865,3060,10,3060,0,3,2005,1270000
6762810985,3590,9,3140,450,4,2006,1210000
6762811120,3740,9,1870,1870,4,1951,1150000
6762811791,4120,10,4120,0,4,2012,949950
6762811818,2720,9,2720,0,4,1957,940000
6762811874,2950,9,2450,500,3,2001,930000
6762812324,2490,8,1610,880,5,1959,868500
6762812877,3990,9,3990,0,4,2003,810000
6762813065,1980,8,1980,0,3,1912,796000
6762813265,1580,9,1580,0,3,2009,779000
6762813411,2230,8,1530,700,2,1947,766500
6762813427,2520,8,1820,700,4,1912,765000
6762813949,2250,9,2250,0,3,2005,729000
6762814501,3290,7,1870,1420,5,2004,695000
6762814612,2450,8,1540,910,3,1962,687500
6762814778,1300,8,880,420,3,1961,676500
6762814819,2260,8,1530,730,4,1976,675000
6762814990,2630,9,2630,0,3,1996,665000
6762814991,2080,8,1220,860,4,1952,665000
6762815585,2940,8,1590,1350,3,1957,635000
6762815676,2320,9,2320,0,3,1992,630000
6762815847,2510,7,1910,600,3,1975,624000
6762816007,1920,7,1070,850,3,1950,615000
6762816008,2950,9,2350,600,5,2005,615000
6762816661,2130,8,2130,0,4,1965,586000
6762816952,2060,8,2060,0,4,1968,575000
6762817074,1460,8,1150,310,3,2006,570000
6762817075,2870,8,1770,1100,2,1994,570000
6762817346,1790,7,1020,770,4,1923,560000
6762817627,1960,8,1240,720,3,1975,550000
6762817974,2100,8,1470,630,3,1948,540000
6762818075,2230,7,2230,0,4,1967,537000
6762818453,1600,7,1600,0,3,1967,525000
6762818454,1740,8,1120,620,3,1996,525000
6762819128,2420,8,2420,0,3,1984,500000
6762819276,2040,7,2040,0,2,1968,499000
6762819426,1720,7,1270,450,3,1947,493000
6762819650,2270,8,2270,0,3,2004,485000
6762819974,3150,9,3150,0,4,2004,475000
6762820532,1240,8,1240,0,2,2006,459000
6762820561,990,6,990,0,2,1942,458000
6762820705,1210,7,1210,0,3,1955,453000
6762820835,2790,9,2790,0,3,1984,450000
6762820836,1510,8,1510,0,2,2006,450000
6762820837,1440,7,1140,300,3,1956,450000
6762821255,2230,7,2230,0,3,2004,440000
6762821256,3180,8,2390,790,4,2007,440000
6762821489,1910,9,1910,0,2,1976,435000
6762821552,1930,7,1110,820,3,1975,434500
6762821670,3880,7,3880,0,5,2004,430000
6762822045,1400,7,1400,0,2,1947,421000
6762822850,1060,7,1060,0,3,1969,400000
6762823086,2340,6,1200,1140,3,1941,396000
6762823224,2220,6,1330,890,4,1917,392000
6762823280,1280,7,940,340,4,1950,390000
6762823554,3220,9,3220,0,5,1999,384000
6762824540,2430,8,1730,700,3,1980,359000
6762824665,1360,7,1360,0,3,1956,355000
6762824896,1280,7,1140,140,2,1942,350000
6762825595,1270,7,1270,0,3,1953,335000
6762825651,1880,7,1880,0,3,1980,334950
6762825794,3597,7,3597,0,5,2006,330000
6762826832,980,7,980,0,3,1969,307500
6762826871,1980,7,1980,0,3,1991,306000
6762827033,1740,7,1740,0,4,1999,302000
6762827125,1740,8,1740,0,4,1989,300000
6762827205,800,6,800,0,2,1904,299950
6762827461,1690,7,1690,0,3,2003,293000
6762827652,1930,8,1930,0,4,1974,289000
6762829640,1300,7,1300,0,3,1983,240000
6762830043,1550,7,1550,0,4,1967,229900
6762830152,2220,7,1200,1020,4,1966,225000
6762830876,1210,7,1210,0,2,1940,198900
6762831458,1080,7,1080,0,3,1955,147400
6762831571,640,5,640,0,1,1920,110000
6762831608,830,6,830,0,2,1939,85000
6762810281,3280,11,3280,0,3,1925,1880000
6762811121,3780,11,2650,1130,3,1999,1150000
6762811195,3320,10,3320,0,4,1988,1110000
6762811196,2770,9,2180,590,4,2014,1110000
6762811604,2120,8,1920,200,4,1929,980000
6762811724,2370,9,1750,620,4,1969,957000
6762812213,2800,9,1890,910,4,1951,880000
6762812628,1570,8,1570,0,3,1927,835000
6762812815,1180,8,1180,0,3,1952,816000
6762812958,2170,8,2170,0,3,2014,802000
6762812987,3320,9,3320,0,5,1999,800000
6762813710,1710,9,1440,270,4,1976,749000
6762813860,3020,8,1510,1510,3,1968,735000
6762814086,2620,9,2620,0,4,1962,720000
6762814114,3110,7,1560,1550,5,1940,719000
6762814820,2240,8,1460,780,4,1976,675000
6762815490,2100,8,1720,380,4,1968,640000
6762815586,3710,8,2510,1200,5,1986,635000
6762815855,2980,8,1690,1290,4,1977,623000
6762816640,1780,8,1780,0,3,1916,588000
6762816696,1700,8,1260,440,3,2010,585000
6762816884,2120,8,1540,580,3,1977,578000
6762817347,1740,8,1740,0,4,1965,560000
6762817467,2350,8,1350,1000,4,1957,555000
6762817628,2080,8,2080,0,3,1988,550000
6762817629,1300,7,990,310,2,1903,550000
6762817630,1040,7,930,110,2,1909,550000
6762818279,3020,7,3020,0,4,2002,530000
6762818923,1970,8,1970,0,3,2007,509950
6762819129,1330,7,1330,0,4,1915,500000
6762819651,1510,8,1510,0,2,2010,485000
6762820463,1860,7,1320,540,3,1985,460000
6762820722,2550,7,1560,990,4,1979,452250
6762820838,1850,7,880,970,3,1982,450000
6762820839,1830,7,1010,820,3,1939,450000
6762821086,1850,7,1280,570,3,1980,445000
6762821257,1760,7,1330,430,3,1983,440000
6762821671,2600,7,1350,1250,3,1965,430000
6762821774,1350,8,1350,0,2,2003,428000
6762821807,2050,7,2050,0,3,2008,427000
6762821824,2120,7,1490,630,4,1976,426000
6762821888,970,7,970,0,2,1910,425000
6762821889,1410,8,1410,0,3,2005,425000
6762821890,1080,6,1080,0,4,1924,425000
6762822089,3070,9,2730,340,5,1983,420000
6762822154,2280,7,1680,600,3,1977,419950
6762822851,1350,7,1350,0,4,1959,400000
6762822852,2150,8,2150,0,4,1998,400000
6762823494,1010,6,1010,0,2,1911,385000
6762823663,1790,8,1790,0,4,1965,380000
6762823757,930,7,930,0,2,1952,379000
6762824273,680,6,680,0,2,1917,365000
6762824439,1930,8,1930,0,4,1996,360000
6762824440,2130,7,1330,800,5,1968,360000
6762824618,2280,8,2280,0,3,1977,356000
6762824761,2170,7,2170,0,3,1995,353000
6762824897,3070,7,2360,710,3,1950,350000
6762825069,2720,8,2120,600,4,1987,348000
6762825465,1320,7,1320,0,3,1943,338995
6762825693,1620,7,1120,500,3,1964,333000
6762825694,1880,8,1880,0,4,1967,333000
6762825795,1570,7,1570,0,3,1953,330000
6762825891,1670,7,1670,0,3,1908,329900
6762826231,2430,8,2430,0,4,2002,321000
6762826355,1980,8,1980,0,3,1991,319950
6762826409,1980,7,1980,0,3,2012,317950
6762826492,1390,7,1390,0,3,1982,315000
6762826640,1890,7,1890,0,4,1966,312000
6762826711,1030,7,1030,0,4,1971,310000
6762827653,780,7,780,0,2,1942,289000
6762827786,1380,7,1380,0,3,1967,285000
6762827954,2400,7,2400,0,6,1991,280000
6762828062,2040,7,2040,0,4,1994,279000
6762828326,1540,7,1160,380,3,1980,272500
6762828418,1380,6,1380,0,2,1954,270000
6762828508,1730,7,1360,370,3,1990,269000
6762828720,710,6,710,0,1,1939,264000
6762828831,2250,8,1320,930,4,1984,260000
6762829573,1500,6,1500,0,3,1970,243000
6762829592,970,7,970,0,3,1972,242000
6762829831,1380,7,1380,0,3,1967,235000
6762829878,1960,7,1220,740,4,1978,234500
6762829980,1190,7,1190,0,3,1955,230000
6762830078,1190,7,1190,0,3,1955,228000
6762830153,1610,7,1100,510,3,1978,225000
6762830345,1310,6,1310,0,2,2004,219000
6762830487,1150,7,1150,0,3,1961,213500
6762830611,1030,5,1030,0,3,1912,209900
6762831154,680,6,680,0,2,1943,179900
6762831267,1180,7,1180,0,3,1970,169950
6762831268,910,5,910,0,3,1900,169900
6762831393,810,7,810,0,2,1980,155000
6762831555,790,6,790,0,2,1944,118125
6762810078,4580,11,3080,1500,4,1991,2900000
6762810454,2980,8,1800,1180,4,1928,1600000
6762811094,2790,10,1930,860,4,1925,1160000
6762811224,3560,8,2760,800,6,1963,1100000
6762811561,2500,9,2370,130,3,1979,990000
6762811718,2830,10,2830,0,3,2014,959000
6762812307,2940,9,2220,720,4,2011,870000
6762813030,3650,9,3330,320,4,2013,799900
6762813076,3040,8,1640,1400,5,1966,795000
6762813229,2440,8,1480,960,4,1929,780000
6762814087,1590,8,1310,280,3,1952,720000
6762814286,2740,9,2740,0,4,2009,706000
6762814299,1690,8,1690,0,4,1959,705000
6762814477,3210,8,3210,0,5,1979,696500
6762814754,3420,9,3420,0,4,2004,679000
6762814865,2810,7,1740,1070,4,1962,674000
6762815194,3040,10,3040,0,3,1993,653000
6762815587,3050,8,3050,0,4,1989,635000
6762815588,2470,8,1780,690,2,2001,635000
6762815635,3500,8,2760,740,5,2005,632500
6762816322,2070,9,1590,480,4,1924,600000
6762816392,1150,7,1150,0,2,1917,599950
6762816569,2520,10,2520,0,3,1988,590000
6762816570,1290,9,1090,200,3,2008,590000
6762816867,3220,8,3220,0,4,2012,579000
6762817304,2310,8,1780,530,4,1968,561500
6762817767,2330,7,1580,750,3,1900,549000
6762817817,2850,8,2340,510,3,2004,545400
6762818675,1830,7,1830,0,3,1909,518000
6762818698,1640,8,1540,100,3,1930,517000
6762819130,2040,7,1280,760,3,1950,500000
6762819494,1980,9,1980,0,3,1979,490000
6762819495,3480,9,1980,1500,4,1977,490000
6762820142,2180,7,1340,840,5,1924,470000
6762821087,2680,7,1340,1340,4,1958,445000
6762821258,1690,7,1230,460,3,1946,440000
6762821379,1990,7,1030,960,3,1978,438000
6762822853,1800,7,1420,380,2,1950,400000
6762823281,1840,7,960,880,3,1972,390000
6762823892,1450,7,1450,0,3,1955,375000
6762823893,1770,7,1770,0,4,1958,375000
6762824274,1440,7,1440,0,2,1985,365000
6762824382,1240,7,1240,0,3,1968,361810
6762824392,2130,7,1330,800,3,1955,361000
6762824898,3500,7,3500,0,6,1980,350000
6762825168,1240,7,1240,0,3,1978,345000
6762825267,940,7,940,0,3,1966,342500
6762825346,1060,6,560,500,2,1947,340000
6762825347,1270,7,1270,0,3,1967,340000
6762825471,2717,8,2717,0,4,2005,338500
6762825695,1250,7,1250,0,3,1954,333000
6762825796,1850,6,1740,110,3,1928,330000
6762826041,1150,7,1150,0,3,1970,325000
6762826181,2240,7,2240,0,3,1943,323500
6762826280,1680,7,1680,0,3,2003,320000
6762826493,1540,7,1540,0,3,1992,315000
6762826494,1160,7,1160,0,3,1909,315000
6762826712,2370,7,2370,0,4,1989,310000
6762826920,1160,7,1160,0,3,1967,305000
6762827126,2744,7,2744,0,6,2006,300000
6762827206,1170,6,1170,0,4,1953,299950
6762827267,3080,7,1610,1470,3,1958,299000
6762827268,1550,7,1250,300,3,1952,299000
6762827885,2420,8,1370,1050,3,1967,282000
6762828049,640,5,640,0,1,1939,279200
6762828311,1650,7,1650,0,3,1989,273000
6762828419,1808,8,1808,0,3,2005,270000
6762829035,1740,7,1740,0,3,1977,255000
6762829243,1200,7,1200,0,2,1985,250000
6762829717,1290,8,1290,0,2,2014,239800
6762829920,1440,5,1440,0,4,1943,232000
6762830770,960,7,960,0,3,1963,201000
6762830845,1590,5,1590,0,2,1920,199950
6762831345,1660,7,1660,0,2,1981,160000
6762810074,6240,11,4610,1630,5,2003,2950000
6762810522,4250,9,2380,1870,4,1974,1530000
6762811400,4570,12,4570,0,3,1991,1040000
6762811550,4260,10,4260,0,5,2005,994000
6762811911,2440,8,1420,1020,4,1950,925000
6762811990,2940,10,2940,0,3,2014,914154
6762812006,2000,9,2000,0,2,1992,910000
6762812173,3540,9,3540,0,4,2014,888990
6762812189,2590,7,1790,800,3,1904,885000
6762812480,3260,9,3260,0,3,1984,850000
6762812481,2900,9,2900,0,4,1993,850000
6762813878,3490,9,3490,0,4,1990,734000
6762813916,3760,9,2820,940,5,2004,730000
6762814055,2600,8,1820,780,4,2003,722500
6762814088,4140,8,4140,0,5,2003,720000
6762814244,2940,9,2940,0,4,2004,710000
6762814268,1680,7,1680,0,4,1911,709000
6762815128,1910,7,1610,300,4,1912,657500
6762816039,1500,7,1500,0,3,1900,614950
6762816055,1960,8,1960,0,3,1988,613000
6762816136,2630,9,2630,0,3,1989,609000
6762816814,1860,7,1860,0,3,1952,580000
6762816815,1430,9,1130,300,3,2009,580000
6762816953,1720,7,860,860,3,1906,575000
6762817177,1900,8,1900,0,4,1966,566000
6762817348,2840,9,2840,0,3,1991,560000
6762817394,2730,8,1670,1060,5,2014,559950
6762817631,2160,8,1410,750,3,1965,550000
6762817975,1720,8,1720,0,3,1987,540000
6762817976,2860,8,2860,0,3,2004,540000
6762818146,2020,7,1370,650,3,1952,535000
6762818402,1950,7,1150,800,5,1960,525126
6762818455,880,7,880,0,2,1940,525000
6762818456,1650,8,1650,0,4,1970,525000
6762818457,960,7,960,0,2,1910,525000
6762818458,1310,8,1310,0,2,2007,525000
6762818997,2350,8,2350,0,4,1968,505000
6762819277,2090,8,2090,0,3,1951,499000
6762819320,1460,8,1050,410,3,2012,497000
6762819975,1790,7,1790,0,3,1987,475000
6762820291,1560,8,790,770,3,1969,465000
6762820464,1690,7,1690,0,3,1941,460000
6762821891,1620,8,1540,80,3,2010,425000
6762822090,1320,7,1320,0,3,1955,420000
6762822571,1380,7,1380,0,3,1925,408000
6762823369,2640,8,2640,0,4,2014,389517
6762823664,1980,10,1580,400,3,1984,380000
6762824149,2420,8,2420,0,3,2014,369946
6762824199,2420,8,2420,0,3,2014,367899
6762824232,1680,8,1680,0,3,1989,366000
6762824233,1210,6,860,350,2,1926,366000
6762824275,2140,8,2140,0,4,1985,365000
6762824441,1960,6,980,980,3,1940,360000
6762824745,2517,8,2517,0,3,2014,353900
6762824899,2520,8,1550,970,5,2004,350000
6762825169,1130,7,1130,0,2,1921,345000
6762825425,1340,7,1340,0,3,1953,339950
6762825797,1790,7,1170,620,4,1969,330000
6762826042,2220,8,1780,440,3,1966,325000
6762826713,990,7,990,0,3,1967,310000
6762826780,1510,7,1510,0,2,1961,309950
6762827197,1580,6,790,790,4,1945,299980
6762827296,2300,8,1300,1000,5,1963,298950
6762827344,1410,7,960,450,3,2014,295500
6762827513,1860,7,1860,0,3,1961,291000
6762828209,1340,7,1340,0,4,1926,275000
6762828210,1960,8,1960,0,4,1967,275000
6762828340,1390,7,1030,360,4,1960,272000
6762828509,1020,7,1020,0,1,1947,269000
6762829036,2560,7,1350,1210,4,1960,255000
6762829244,1350,7,1350,0,3,1985,250000
6762829245,1590,7,1060,530,3,1996,250000
6762829388,1470,7,1220,250,3,1946,248000
6762829900,1650,7,1650,0,3,1985,233703
6762830090,1130,6,1130,0,3,1954,227000
6762830380,1110,7,1110,0,3,1966,217000
6762830439,1130,7,1130,0,4,1969,215000
6762830440,1610,6,1610,0,3,1968,215000
6762831577,800,6,800,0,2,1942,109500
6762810022,9890,13,8860,1030,6,2001,6890000
6762811359,2480,9,1330,1150,3,1967,1050000
6762812522,2520,9,1460,1060,3,1954,849000
6762812695,3720,10,3720,0,4,1983,828500
6762812724,1820,8,1820,0,4,1923,825000
6762813077,3520,9,3520,0,4,2012,795000
6762813257,2840,9,2840,0,4,2014,779950
6762813818,2780,9,2780,0,4,2002,739000
6762814166,3260,10,3260,0,4,1997,715000
6762814454,1820,8,1820,0,3,1937,699000
6762814607,1760,8,1290,470,3,1928,688000
6762814770,2440,8,2440,0,3,2010,677900
6762814992,1260,7,1260,0,3,1937,665000
6762815272,2640,9,2640,0,4,2001,650000
6762815548,4083,10,4083,0,4,2005,637000
6762815792,1560,8,1240,320,3,1995,625000
6762815793,1460,8,1000,460,2,2008,625000
6762815905,1680,8,1680,0,2,1983,620000
6762816481,1920,7,1300,620,4,1923,595000
6762816571,3030,7,2100,930,3,1959,590000
6762816816,2040,8,2040,0,3,1980,580000
6762817440,1800,7,1160,640,3,1929,556000
6762817468,1680,7,840,840,4,1915,555000
6762817469,1950,8,1950,0,2,2009,555000
6762817632,3080,9,3080,0,4,2003,550000
6762817633,2810,9,2810,0,4,1992,550000
6762817748,3610,8,3610,0,5,2003,549900
6762817977,2280,6,1760,520,3,1909,540000
6762818107,2070,8,1720,350,3,1973,535100
6762818147,1940,7,970,970,2,1937,535000
6762818280,1260,8,1260,0,2,2007,530000
6762818392,1220,8,930,290,3,2014,526000
6762818459,2450,8,2450,0,4,2003,525000
6762818746,1600,8,1600,0,3,1955,515000
6762819369,2570,8,1910,660,4,1978,495000
6762819496,2090,8,2090,0,4,1970,490000
6762819571,1510,7,910,600,3,1972,489000
6762820177,1620,7,1220,400,3,1962,469950
6762820178,3223,9,3223,0,5,2014,469950
6762820840,2180,8,2180,0,3,2004,450000
6762821395,1260,8,1260,0,3,2002,437500
6762821427,1460,8,1200,260,3,2008,436000
6762821490,720,7,720,0,2,1920,435000
6762821491,2240,7,1120,1120,2,1940,435000
6762821598,1660,7,1660,0,3,1970,432000
6762822155,2220,7,2220,0,4,2002,419950
6762823125,2060,7,1070,990,4,1957,395000
6762823356,2245,8,2245,0,4,2014,389990
6762823407,2640,8,2640,0,4,2011,387990
6762823555,2100,7,1050,1050,4,1955,384000
6762823758,1580,8,1580,0,3,2013,379000
6762823894,1130,7,1130,0,3,1954,375000
6762824541,1890,7,1890,0,4,1955,359000
6762824569,1400,7,1400,0,3,2005,358000
6762824619,920,6,920,0,3,1970,356000
6762824900,2440,8,2440,0,3,1994,350000
6762824901,2010,7,2010,0,3,1939,350000
6762824902,1530,7,1530,0,4,1914,350000
6762825348,2380,8,1500,880,4,1999,340000
6762825596,1700,7,1700,0,3,1997,335000
6762826629,2910,8,2910,0,4,2004,312200
6762826781,1200,7,1200,0,3,1985,309950
6762826921,1914,8,1914,0,4,2009,305000
6762827787,920,6,920,0,2,1900,285000
6762827788,2110,7,1670,440,5,2002,285000
6762827955,1934,8,1934,0,4,2013,280000
6762828063,1540,7,1080,460,3,1974,279000
6762829599,2500,8,1830,670,4,1979,241500
6762830154,1290,7,970,320,3,1966,225000
6762830281,1830,7,1830,0,5,1929,220000
6762830441,1150,6,1150,0,3,1958,215000
6762830622,1390,7,1390,0,3,2009,208800
6762830919,1510,6,1510,0,3,1913,195000
6762831067,1320,6,1320,0,3,1961,185000
6762831329,1440,5,1440,0,4,1943,162000
6762831595,1070,6,1070,0,2,1948,95000
6762816009,1210,6,1210,0,2,1907,615000
6762818148,1970,8,1030,940,4,1969,535000
6762819793,2410,7,2410,0,3,2009,480000
6762826397,1550,7,1030,520,5,1978,318500
6762830920,1050,6,1050,0,3,1969,195000
6762811063,3270,9,2470,800,5,1968,1180000
6762814368,1490,9,1490,0,2,2014,700000
6762816954,2760,8,1730,1030,5,1926,575000
6762819131,2670,9,1640,1030,4,2013,500000
6762826621,870,7,870,0,2,1948,312500
6762810104,3280,11,2880,400,4,2011,2580000
6762810374,3860,11,2940,920,4,2004,1700000
6762810673,3450,9,2180,1270,4,1964,1390000
6762811016,2160,9,2160,0,2,1956,1200000
6762811321,4510,8,3270,1240,4,1941,1060000
6762811424,3050,8,1650,1400,5,1962,1030000
6762811534,3620,10,2730,890,3,1988,996000
6762811912,1630,8,1630,0,3,1912,925000
6762812071,3620,10,3620,0,4,1984,900000
6762812158,2610,8,1260,1350,4,1920,890000
6762812308,3610,10,3610,0,4,2000,870000
6762812338,2260,8,1770,490,4,1974,865000
6762812421,2270,9,2270,0,4,1965,855000
6762812526,3010,10,3010,0,3,2000,848000
6762813026,3030,9,3030,0,4,2014,799950
6762813230,3000,10,2410,590,2,1952,780000
6762813374,3310,9,3310,0,3,2006,770000
6762813964,2660,8,1940,720,3,1910,727500
6762814167,1986,8,1746,240,4,1922,715000
6762814199,2580,8,1720,860,5,1967,713000
6762814440,2380,7,1540,840,4,1961,699900
6762814535,1780,7,980,800,2,1922,691000
6762815273,2520,8,1790,730,3,1957,650000
6762815906,2500,9,2500,0,4,2013,620000
6762816010,2330,8,1450,880,4,1973,615000
6762816452,2690,8,2690,0,7,1960,597157
6762816546,1460,7,1460,0,3,1902,591000
6762817211,1880,7,1260,620,3,1967,565000
6762817268,2780,9,2780,0,4,2004,563500
6762817309,1640,8,1640,0,3,1985,561000
6762817634,1700,8,1700,0,3,2002,550000
6762817846,1400,7,1400,0,3,1925,545000
6762818149,920,7,920,0,1,1906,535000
6762818460,1890,8,1890,0,4,1967,525000
6762818461,2140,8,2140,0,4,1996,525000
6762818869,1600,7,990,610,3,1978,510000
6762819132,2290,8,1270,1020,4,1969,500000
6762819133,1530,7,1100,430,3,1977,500000
6762819652,1880,8,1880,0,3,1988,485000
6762819976,2130,8,2130,0,3,1985,475000
6762820143,2120,8,1770,350,3,2005,470000
6762820144,2000,7,1300,700,3,1968,470000
6762820145,2470,8,2470,0,4,2002,470000
6762821145,1640,6,1640,0,3,1916,443000
6762821259,2260,7,1200,1060,3,1940,440000
6762821672,1440,6,720,720,3,1917,430000
6762822234,1840,8,1840,0,3,1993,417000
6762822263,1240,7,1240,0,3,1958,415500
6762822392,1770,7,1770,0,4,2007,413900
6762822658,2070,7,2070,0,3,2002,405000
6762822708,1410,7,1410,0,3,1950,404000
6762822778,1350,7,1350,0,3,2003,401000
6762822854,1980,7,1980,0,4,1962,400000
6762822855,1560,7,1560,0,3,1970,400000
6762823030,1420,7,1420,0,4,1953,398000
6762823282,1180,7,1180,0,3,1959,390000
6762824276,2140,7,2140,0,3,1983,365000
6762824277,950,7,950,0,3,1962,365000
6762824338,1750,8,1750,0,4,1968,364000
6762824346,2680,8,2680,0,4,1990,363500
6762824442,1340,7,1040,300,3,1999,360000
6762824443,1360,6,860,500,3,1911,360000
6762824762,1900,7,1900,0,3,2006,353000
6762825048,1340,7,1340,0,3,2008,349000
6762825126,1350,6,1350,0,3,1944,345500
6762825245,1900,7,1900,0,3,2004,343500
6762825597,2240,9,2240,0,4,1989,335000
6762825896,1730,8,1730,0,3,2014,329780
6762826043,1530,7,1130,400,4,1957,325000
6762826239,1220,6,720,500,3,1947,320600
6762826446,2320,8,2320,0,4,1987,316000
6762826495,1950,7,1950,0,3,1992,315000
6762827127,1320,7,1320,0,3,1979,300000
6762827654,1670,7,1670,0,3,1990,289000
6762827698,2270,7,1540,730,4,1959,287000
6762827871,1710,7,1710,0,4,2014,282900
6762827878,700,7,700,0,2,1948,282150
6762828161,1060,6,1060,0,2,1950,275053
6762828539,1680,7,1100,580,4,1977,268000
6762828644,1400,7,1060,340,3,1961,265000
6762828740,1490,6,700,790,3,1913,263000
6762828832,2170,7,1630,540,3,1978,260000
6762829037,1580,7,1580,0,4,1959,255000
6762829091,1794,7,1794,0,3,2005,254950
6762829104,1560,7,1560,0,3,1994,254000
6762829581,1550,7,1550,0,3,2005,242500
6762830091,1510,7,1510,0,3,1989,227000
6762830282,2130,8,1290,840,4,1978,220000
6762830651,1460,7,1460,0,3,1956,207000
6762831252,1480,6,780,700,3,1944,170000
6762831450,1090,6,1090,0,3,1969,149000
6762810055,7100,13,5240,1860,6,1933,3200000
6762810107,4475,12,2659,1816,4,1999,2570000
6762810332,3980,10,3980,0,4,2011,1770000
6762810570,4570,10,4570,0,5,1965,1480000
6762810953,4390,9,2930,1460,5,2008,1230000
6762811017,2860,8,2160,700,5,1910,1200000
6762811197,3600,9,2610,990,6,1945,1110000
6762811275,3740,9,2860,880,5,2014,1080000
6762811493,2370,9,1670,700,3,1971,1000000
6762811541,2460,10,2460,0,3,1992,995000
6762812769,2290,8,2290,0,3,1984,822000
6762812910,2590,8,2590,0,3,1951,808000
6762812944,2770,9,2770,0,5,1985,804000
6762813308,3310,9,3310,0,4,2005,775000
6762813309,3060,9,2410,650,4,2012,775000
6762813717,2810,9,2810,0,4,1993,747500
6762813879,3090,8,2340,750,4,1959,734000
6762814767,2770,8,1640,1130,3,1962,678000
6762815274,2300,8,1150,1150,3,1938,650000
6762815275,2290,8,2290,0,4,1985,650000
6762815359,3990,9,2400,1590,5,1991,649000
6762815360,3130,9,3130,0,4,2014,649000
6762815436,2350,9,2350,0,3,1966,643403
6762815735,1610,7,910,700,3,1928,626500
6762815794,2190,8,1990,200,4,1925,625000
6762815848,2810,8,1680,1130,4,1980,624000
6762815907,2720,7,1360,1360,4,1966,620000
6762815967,1910,8,1910,0,3,1998,617000
6762816147,2410,8,2410,0,4,1993,608000
6762816572,2240,7,1540,700,4,1940,590000
6762816697,1950,8,1950,0,4,2004,585000
6762816766,1670,8,1427,243,4,2000,582000
6762817076,3140,8,1900,1240,4,1968,570000
6762817281,2920,8,2920,0,5,2007,562500
6762817470,2170,8,1290,880,4,1977,555000
6762817635,2470,9,2470,0,4,2006,550000
6762817917,1990,8,1540,450,3,1964,542000
6762817918,2020,7,1480,540,4,1928,542000
6762818281,1950,8,1950,0,3,2002,530000
6762818462,1620,9,1080,540,2,2007,525000
6762818463,1580,7,1290,290,4,1945,525000
6762818705,2390,7,2390,0,6,1925,516250
6762818934,1560,8,1560,0,2,2006,509000
6762818998,2400,7,1390,1010,3,1977,505000
6762819044,1770,7,1170,600,3,1958,502550
6762819243,1820,8,1430,390,3,2014,499950
6762819296,1910,8,1910,0,3,1989,498688
6762819794,1820,8,1220,600,3,1977,480000
6762819977,2300,6,2300,0,5,1994,475000
6762819978,1190,7,960,230,3,1999,475000
6762820632,2440,8,2440,0,4,2005,455000
6762821088,2210,8,2210,0,3,1998,445000
6762821492,1740,7,1600,140,3,1950,435000
6762821673,2290,7,2290,0,4,2003,430000
6762822091,1230,7,1230,0,3,1963,420000
6762822235,2090,6,1060,1030,4,1907,417000
6762822596,2400,7,1200,1200,5,1974,406550
6762822762,1970,8,1970,0,3,1990,402000
6762823126,1610,7,1610,0,3,1987,395000
6762823196,980,7,980,0,2,1925,393000
6762823359,1700,7,1700,0,3,2003,389950
6762823586,1150,7,1150,0,3,1952,382500
6762823665,2030,8,1610,420,4,1950,380000
6762824085,1040,7,1040,0,2,1946,370000
6762824666,1960,7,980,980,3,1950,355000
6762824725,1720,7,1720,0,3,1971,354900
6762824734,2900,8,2900,0,4,2005,354000
6762824903,1600,8,1600,0,3,1999,350000
6762824904,1840,7,1200,640,3,1987,350000
6762825223,2240,7,1120,1120,4,1956,344950
6762825598,1670,7,1100,570,4,1960,335000
6762825599,2130,7,2130,0,3,1917,335000
6762826044,1930,7,1930,0,4,1993,325000
6762826045,2090,6,2090,0,4,1949,325000
6762826413,1000,6,1000,0,2,1902,317500
6762826496,2300,7,1560,740,4,1979,315000
6762826497,2740,8,2740,0,4,1993,315000
6762827379,840,6,840,0,2,1951,295000
6762827471,2140,7,1420,720,4,1968,292500
6762827514,1890,8,1260,630,4,1979,291000
6762827555,1900,7,1400,500,4,1959,290000
6762827556,740,6,740,0,1,1928,290000
6762828211,1240,7,1240,0,3,1967,275000
6762828833,1810,7,1240,570,3,1978,260000
6762828834,1650,7,1010,640,4,1977,260000
6762828914,1260,7,1260,0,4,1955,259000
6762828952,1530,7,1070,460,3,1979,257500
6762829142,1280,7,1280,0,2,1967,252500
6762829484,1120,6,720,400,2,1904,245000
6762829485,1720,7,1720,0,3,1992,245000
6762829565,2300,7,2300,0,4,1966,243500
6762829582,1770,7,1340,430,3,1978,242500
6762829641,1520,7,1160,360,3,1993,240000
6762829879,1310,7,870,440,3,1954,234500
6762829981,1640,7,1640,0,3,1966,230000
6762830080,1670,7,1670,0,3,1954,227950
6762830262,990,6,990,0,2,1949,220500
6762830501,1270,6,1270,0,3,1954,212500
6762831068,1760,7,1230,530,4,1966,185000
6762831197,1210,7,1210,0,4,1962,175000
6762831242,1640,7,1040,600,3,1960,170500
6762831346,1470,7,1160,310,3,1985,160000
6762831436,790,6,790,0,2,1944,150000
6762810342,3845,10,3845,0,4,2013,1750000
6762810773,3180,10,3180,0,4,1905,1320000
6762810901,3160,9,3160,0,4,2011,1250000
6762811046,2550,9,1650,900,3,1951,1190000
6762811594,2110,8,2110,0,4,1968,981000
6762812072,2260,8,1700,560,3,1925,900000
6762812482,2170,8,2170,0,2,1952,850000
6762812725,2290,7,2150,140,4,1921,825000
6762812758,3650,10,3650,0,4,1996,824000
6762813819,4000,7,4000,0,6,1978,739000
6762813880,4110,10,2970,1140,5,2000,734000
6762814062,1790,7,920,870,2,1915,721000
6762814168,2890,8,2890,0,3,2004,715000
6762814300,2820,9,1780,1040,3,1979,705000
6762814639,1650,8,1470,180,3,1959,685000
6762814712,2330,8,1590,740,3,1968,680000
6762814821,2510,8,2510,0,3,1907,675000
6762814993,2420,7,1670,750,4,1946,665000
6762815160,2200,8,1430,770,4,1971,655000
6762815276,5110,10,3850,1260,5,2003,650000
6762815342,2130,9,2130,0,4,1976,649990
6762815491,2970,9,2970,0,4,1998,640000
6762815795,2190,8,2190,0,4,1952,625000
6762816323,4440,10,4440,0,5,2012,600000
6762816400,3030,8,1760,1270,3,1984,599900
6762816456,2280,8,1520,760,4,1921,597000
6762816648,1780,8,1310,470,4,1951,587500
6762816955,2168,8,2168,0,3,1907,575000
6762816956,1230,7,880,350,2,1920,575000
6762817559,2170,8,2170,0,4,2014,551000
6762817636,2360,7,2360,0,3,2003,550000
6762817637,2880,7,1440,1440,1,1925,550000
6762817638,4180,11,4180,0,4,1986,550000
6762817749,3800,9,3800,0,5,1984,549900
6762817847,2290,8,2290,0,3,1981,545000
6762817919,890,7,770,120,2,1910,542000
6762818076,1720,7,860,860,4,1950,537000
6762818610,2190,8,2190,0,4,1992,520000
6762819759,1730,8,1730,0,3,1996,480680
6762820112,1010,7,1010,0,2,1921,470450
6762820187,2090,7,1140,950,4,2001,469500
6762820292,2100,8,2100,0,4,1979,465000
6762820465,2390,9,2390,0,3,2007,460000
6762821017,1310,7,1310,0,3,1958,447000
6762821132,1460,8,1460,0,3,1987,444000
6762821765,2598,9,2598,0,4,2014,428900
6762821892,2110,7,1460,650,2,1911,425000
6762821893,1340,8,1340,0,2,2008,425000
6762822494,1660,7,1000,660,2,1950,410000
6762822786,2320,7,1400,920,2,1948,400950
6762822856,2170,7,2170,0,4,1980,400000
6762822857,530,6,530,0,1,1949,400000
6762822858,2390,7,2390,0,3,1975,400000
6762823031,1300,8,1300,0,2,2006,398000
6762823127,1910,7,1460,450,4,1975,395000
6762823283,1710,7,1710,0,3,1953,390000
6762823284,2860,7,1730,1130,4,1983,390000
6762823412,1220,6,1220,0,3,1946,387500
6762823597,1360,8,1360,0,3,1936,382000
6762824086,1560,6,1060,500,3,1927,370000
6762824339,1280,7,1280,0,2,1992,364000
6762824444,1381,8,1381,0,3,2007,360000
6762824509,2450,8,2450,0,5,1973,359950
6762824542,2770,8,2100,670,4,1996,359000
6762824735,1010,8,1010,0,3,1980,354000
6762824763,1920,8,1010,910,4,1998,353000
6762824821,1550,6,1550,0,4,1959,351000
6762825170,2550,7,2550,0,2,1993,345000
6762825600,1790,6,940,850,3,1949,335000
6762826046,1780,7,900,880,4,1976,325000
6762826281,2110,7,1290,820,4,1979,320000
6762826498,2020,8,2020,0,4,1995,315000
6762826880,1850,7,1850,0,4,1989,305500
6762826979,670,6,670,0,2,1942,304950
6762827034,1540,7,1540,0,5,1960,302000
6762827335,1560,7,1560,0,3,2003,296000
6762827557,1210,7,1210,0,3,1954,290000
6762827655,1850,8,1850,0,3,1988,289000
6762827956,2630,7,1330,1300,3,1958,280000
6762827957,1720,7,860,860,3,1969,280000
6762827958,1600,7,1600,0,3,1996,280000
6762828212,1730,7,1730,0,3,1987,275000
6762828727,2210,8,1640,570,4,1977,263500
6762828964,1810,7,1810,0,3,1992,257000
6762829486,1840,7,1570,270,2,1938,245000
6762829546,1300,6,650,650,2,1939,244500
6762829725,1470,7,1470,0,3,1957,239000
6762830034,2000,7,1260,740,5,1994,229950
6762830366,1140,6,1140,0,3,1958,218000
6762830506,1100,6,1100,0,3,1967,212000
6762830644,1260,6,1260,0,4,1991,207200
6762830755,1330,8,1330,0,2,1979,202200
6762831130,1330,7,1330,0,3,1978,180000
6762831155,1230,6,1230,0,3,1970,179900
6762831286,760,5,760,0,3,1903,167500
6762831398,890,6,890,0,3,1957,154500
6762831516,1200,7,1200,0,3,1908,130000
6762831534,810,5,810,0,2,1942,125000
6762831560,1080,5,1080,0,3,1950,115000
6762810851,3260,9,2300,960,4,1930,1280000
6762810881,3110,8,1640,1470,3,1954,1260000
6762811875,3780,10,3780,0,3,1986,930000
6762812629,2460,9,1490,970,5,1955,835000
6762812854,2270,9,2270,0,4,2014,812000
6762813375,3680,9,2670,1010,4,1930,770000
6762813631,1300,7,1300,0,2,1943,750000
6762813861,1610,8,1610,0,3,1925,735000
6762813917,3460,9,2560,900,3,1988,730000
6762814008,3570,9,3570,0,3,1997,725000
6762814089,2530,8,1530,1000,4,1957,720000
6762814323,2510,8,2050,460,4,1976,704000
6762814779,2270,8,1290,980,4,1954,676101
6762815016,2390,9,2390,0,4,1998,664000
6762815277,2820,9,2820,0,4,1985,650000
6762815352,2280,8,2280,0,4,1995,649800
6762816760,1540,7,1020,520,2,1942,582500
6762817077,2400,7,2400,0,3,1991,570000
6762818195,1930,8,1930,0,3,1990,533600
6762818212,1620,7,980,640,3,1927,532500
6762819134,1510,6,930,580,2,1924,500000
6762819497,990,8,840,150,3,2007,490000
6762819611,3250,9,3250,0,4,2014,486940
6762819740,2600,7,1300,1300,3,1980,482000
6762819844,1820,9,1820,0,3,2014,479950
6762819898,1750,7,950,800,3,1916,477000
6762820293,3050,8,1550,1500,4,1983,465000
6762820294,1100,6,1100,0,3,1915,465000
6762820514,2800,9,2800,0,4,2006,459950
6762820841,1660,7,1130,530,3,1968,450000
6762821089,1190,7,1190,0,3,1984,445000
6762821130,2600,7,2600,0,3,2002,444500
6762821260,2730,8,1470,1260,5,1979,440000
6762821343,790,7,790,0,1,1918,439000
6762821894,2480,7,2480,0,4,2005,425000
6762822236,1190,7,1190,0,2,1928,417000
6762822316,3040,8,2240,800,4,2002,415000
6762822389,1790,8,1790,0,3,2013,414000
6762822591,740,6,740,0,2,1912,407000
6762822859,2150,7,2150,0,4,1952,400000
6762822996,860,6,860,0,3,1942,399000
6762822997,1120,7,1120,0,2,1946,399000
6762823225,2340,7,2340,0,5,2009,392000
6762823569,1150,7,1150,0,3,1957,383000
6762824044,1200,7,1200,0,3,1975,370900
6762824141,1360,7,1360,0,3,1987,369950
6762824393,1650,7,1650,0,3,1969,361000
6762824499,3220,8,3220,0,4,1976,359999
6762824543,1580,6,790,790,4,1945,359000
6762824667,2770,7,1940,830,4,1979,355000
6762825227,1820,7,1100,720,4,1955,344900
6762825251,1400,5,1400,0,3,1920,343000
6762825349,1210,7,1210,0,3,1987,340000
6762825601,1350,6,1350,0,3,1981,335000
6762825715,2580,7,1360,1220,3,1953,332220
6762825798,1520,7,1520,0,3,2009,330000
6762825937,1360,7,1360,0,4,1948,328000
6762826047,1880,8,1880,0,3,1993,325000
6762826048,2130,7,1600,530,4,1975,325000
6762826282,1510,7,1510,0,3,1976,320000
6762826379,1730,6,1730,0,4,1954,319000
6762826380,960,7,960,0,3,1971,319000
6762827789,1800,7,1800,0,3,2001,285000
6762828138,1480,7,1180,300,3,1986,276200
6762828835,2050,7,1300,750,4,1965,260000
6762828953,1140,7,1140,0,3,1991,257500
6762829038,2800,7,2800,0,5,1964,255000
6762829246,2320,7,1290,1030,5,1962,250000
6762829487,1550,7,1550,0,3,1957,245000
6762829642,1880,7,1020,860,4,1946,240000
6762829779,1300,7,1300,0,3,1961,236000
6762829982,1510,7,1510,0,3,1947,230000
6762830155,900,6,790,110,3,1944,225000
6762830526,2040,6,1430,610,2,1985,210500
6762830565,880,6,880,0,2,1938,210000
6762830949,1400,7,1400,0,3,1964,194000
6762831131,1280,6,1280,0,3,1969,180000
6762831198,740,6,740,0,2,1920,175000
6762831347,1520,7,1520,0,4,1960,160000
6762810083,5350,10,5020,330,7,1910,2890000
6762810455,3570,10,3570,0,5,2014,1600000
6762810723,3500,10,3500,0,4,1999,1350000
6762810902,4610,8,2790,1820,3,1947,1250000
6762810972,3090,8,3090,0,4,1918,1220000
6762811947,3470,10,3470,0,4,1993,920000
6762812214,4060,9,4060,0,4,1996,880000
6762812784,2950,10,2950,0,3,1995,820000
6762813153,3320,9,3320,0,4,2005,786000
6762813310,3890,10,3890,0,4,1996,775000
6762813428,1660,7,990,670,2,1940,765000
6762814059,3190,9,3190,0,4,2005,722000
6762814245,1740,8,1740,0,4,1958,710000
6762814592,3220,10,3220,0,4,1993,689000
6762814593,2020,7,2020,0,4,1954,689000
6762814713,3030,9,3030,0,4,1978,680000
6762814942,2290,8,1780,510,4,1976,668500
6762816011,1900,7,1110,790,3,1927,615000
6762816324,3580,8,2140,1440,5,1937,600000
6762816418,1550,7,1550,0,2,1930,599000
6762816438,2520,10,2520,0,3,1978,598500
6762816614,2840,9,2840,0,3,2014,589410
6762816698,2270,8,1300,970,4,1957,585000
6762816897,1940,7,1940,0,5,1951,577000
6762816957,2630,8,2630,0,4,1992,575000
6762817078,1860,8,1860,0,4,1964,570000
6762817132,1960,7,1960,0,4,1907,569500
6762817138,1230,7,1090,140,4,1950,569000
6762817212,2330,9,2330,0,4,1987,565000
6762817349,3440,9,3440,0,3,1990,560000
6762817350,2870,9,1350,1520,3,1980,560000
6762817932,1790,8,1790,0,3,2005,541000
6762818464,1520,8,1520,0,3,1969,525000
6762818465,1570,7,1570,0,4,1920,525000
6762818576,2835,8,2835,0,4,2002,522000
6762818999,2770,8,1910,860,2,1984,505000
6762819135,2270,7,1150,1120,4,1963,500000
6762819278,1750,7,1230,520,3,1900,499000
6762819462,3000,7,1970,1030,3,1998,490500
6762819498,3000,8,3000,0,4,1985,490000
6762820146,2770,8,2370,400,3,1938,470000
6762820466,1300,7,900,400,3,1953,460000
6762820842,2620,9,2620,0,3,1989,450000
6762820843,2820,8,1410,1410,3,1954,450000
6762821895,1500,7,1060,440,3,1981,425000
6762821896,1280,8,1280,0,2,1918,425000
6762822317,880,7,880,0,2,1951,415000
6762822779,1120,6,1120,0,3,1941,401000
6762823128,1620,8,1540,80,2,2004,395000
6762823208,1050,7,1050,0,2,1909,392500
6762823285,2570,7,2570,0,4,1958,390000
6762823895,1580,8,1580,0,3,2011,375000
6762824165,1340,8,1340,0,3,1997,369000
6762824278,1780,8,1780,0,3,2007,365000
6762824333,1600,6,800,800,3,1944,364500
6762824445,1230,8,1230,0,2,2006,360000
6762824668,2160,8,2160,0,3,2000,355000
6762824780,1800,8,1800,0,4,2014,352800
6762824905,1010,6,750,260,4,1925,350000
6762824906,1180,7,1180,0,3,1964,350000
6762824907,2500,8,2500,0,4,2007,350000
6762825039,2030,8,2030,0,4,2014,349500
6762825696,2100,8,2100,0,4,1997,333000
6762825799,1590,7,1590,0,3,1954,330000
6762826381,1800,7,1200,600,3,1963,319000
6762826447,1010,6,1010,0,3,1977,316000
6762826922,820,6,820,0,3,1918,305000
6762827128,1500,6,1500,0,3,1933,300000
6762827269,1950,7,1950,0,4,2002,299000
6762827270,1870,7,1870,0,4,1996,299000
6762827442,1320,7,990,330,3,1953,294000
6762827862,1480,6,1480,0,4,1942,283000
6762827959,2400,8,2400,0,4,2004,280000
6762828064,1020,7,1020,0,2,1904,279000
6762828341,2070,8,2070,0,4,1993,272000
6762828760,1700,8,1700,0,3,1997,262000
6762829447,1040,7,1040,0,3,1942,245990
6762829643,1220,7,1220,0,3,1980,240000
6762829644,1030,7,1030,0,3,1970,240000
6762829645,1410,7,940,470,3,1980,240000
6762829832,960,7,960,0,3,1955,235000
6762829921,1290,7,1290,0,3,1984,232000
6762829983,940,7,940,0,3,1957,230000
6762830283,1620,7,1620,0,4,1978,220000
6762830479,1600,7,1600,0,3,2003,214000
6762830898,1310,7,1310,0,3,1979,196500
6762831110,1060,7,1060,0,3,1959,182000
6762831253,870,6,870,0,2,1948,170000
6762831277,910,7,910,0,3,1969,169000
6762831288,1520,7,1520,0,3,1949,167000
6762810514,4910,10,2560,2350,4,1964,1540000
6762812261,2850,7,2040,810,4,1926,875000
6762813632,3150,8,1810,1340,4,1976,750000
6762819136,1760,7,1300,460,2,1951,500000
6762822599,1780,8,1780,0,3,1992,406500
6762818229,2810,9,2810,0,4,2014,531155
6762821261,2230,7,2230,0,4,2011,440000
6762828899,1690,7,1690,0,3,1986,259900
6762810114,6930,11,4310,2620,4,1950,2530000
6762810141,3650,9,1830,1820,4,2000,2400000
6762810583,2650,9,2400,250,4,1909,1460000
6762810866,3200,11,3200,0,4,1984,1270000
6762810882,2970,9,2970,0,4,1900,1260000
6762811122,3250,10,2260,990,3,2006,1150000
6762811150,4280,10,4280,0,5,2014,1140000
6762811425,4110,7,4110,0,3,1976,1030000
6762811884,3570,9,3570,0,4,2014,928990
6762812483,3870,10,3870,0,5,1994,850000
6762812484,3180,9,3180,0,4,1977,850000
6762812541,1720,8,1720,0,5,1951,845000
6762812816,2060,8,2060,0,5,1907,815241
6762813736,2760,9,2760,0,4,1989,745000
6762813785,2420,9,1820,600,3,1907,740000
6762814009,2420,9,2420,0,4,1984,725000
6762814115,2210,7,1470,740,4,1926,719000
6762814465,2680,7,1340,1340,6,1967,698000
6762814502,3530,9,2660,870,4,2000,695000
6762814564,2820,9,2820,0,4,1990,690000
6762814691,3860,8,2930,930,4,2004,681000
6762814870,2590,8,2590,0,4,1980,673000
6762815278,2500,9,2500,0,4,2001,650000
6762815279,2220,8,1660,560,3,1931,650000
6762815346,1670,9,1350,320,3,2014,649950
6762815740,1350,7,1350,0,4,1954,626000
6762815937,1520,7,920,600,2,1951,619950
6762816102,2320,8,2320,0,3,1980,610000
6762816419,3700,7,1840,1860,4,1962,599000
6762816817,2610,8,1700,910,4,1977,580000
6762817351,970,7,970,0,2,1944,560000
6762817471,2240,8,2240,0,3,1968,555000
6762817472,2100,9,1450,650,3,2011,555000
6762817639,2160,7,1760,400,3,1933,550000
6762817640,3650,7,3650,0,3,1991,550000
6762817800,1520,7,1020,500,4,1946,546800
6762819037,2470,9,2470,0,4,2005,503000
6762819370,2460,8,2460,0,4,2006,495000
6762819617,1800,8,1800,0,4,1999,485500
6762820223,2260,7,1130,1130,3,1948,467500
6762820430,3284,8,3284,0,4,2014,460458
6762820633,1030,6,1030,0,2,1917,455000
6762821323,2460,8,1720,740,4,1977,439950
6762821493,1730,8,1730,0,3,1991,435000
6762821897,970,7,970,0,3,1956,425000
6762821898,1730,7,980,750,4,1955,425000
6762821899,1320,8,1180,140,2,2007,425000
6762822002,1140,7,620,520,3,1925,424000
6762822254,880,6,880,0,2,1918,416000
6762822434,2420,7,1360,1060,5,1929,411500
6762822659,1790,8,1790,0,2,1979,405000
6762823129,2130,7,1330,800,4,1969,395000
6762823401,2090,9,2090,0,4,2014,388000
6762823495,1420,7,1200,220,3,1954,385000
6762823543,2380,8,2380,0,4,2006,384950
6762823607,2160,9,2160,0,2,1985,381500
6762824279,2540,9,2540,0,4,2002,365000
6762824446,2470,7,1270,1200,4,1974,360000
6762824669,2040,7,1360,680,4,1967,355000
6762825016,1820,7,1820,0,4,1999,349950
6762825070,2360,8,2360,0,3,2011,348000
6762825350,640,6,640,0,1,1918,340000
6762826283,710,6,710,0,2,1942,320000
6762826499,1070,7,1070,0,3,1955,315000
6762826585,2390,7,2390,0,4,1996,314500
6762826923,1560,6,1560,0,4,1954,305000
6762827790,1120,7,1120,0,3,1954,285000
6762827960,1670,7,990,680,3,1957,280000
6762828213,1230,7,1230,0,3,1973,275000
6762828420,2440,7,1200,1240,4,1963,270000
6762828774,1640,6,1220,420,4,1943,261490
6762828836,1427,7,1427,0,3,2009,260000
6762828888,790,6,790,0,2,1947,259950
6762829039,1970,7,1170,800,5,1977,255000
6762829040,1160,6,1160,0,3,1923,255000
6762829128,1570,7,1570,0,3,1971,253000
6762829488,1730,7,1730,0,3,1987,245000
6762829646,2040,7,2040,0,4,1994,240000
6762829922,960,6,810,150,2,1936,232000
6762829935,1640,7,1040,600,3,1977,231000
6762829940,1690,7,1160,530,3,1973,230500
6762830652,920,6,920,0,3,1928,207000
6762830861,860,6,860,0,3,1955,199129
6762810131,4670,11,4670,0,7,1992,2450000
6762811633,2720,10,2500,220,4,1981,975000
6762812339,1790,7,1790,0,3,1953,865000
6762812485,5440,9,2720,2720,4,1969,850000
6762813451,1420,8,1420,0,3,1904,764000
6762815161,2630,8,2630,0,4,2002,655000
6762815677,2540,7,2540,0,4,1957,630000
6762815711,2160,9,1970,190,3,2014,629000
6762816165,2810,8,2040,770,3,1988,607000
6762816818,1620,8,1470,150,3,2008,580000
6762816958,2120,7,2120,0,3,2004,575000
6762817473,1160,8,960,200,2,2014,555000
6762817768,1230,8,1230,0,3,2013,549000
6762818383,2380,7,1410,970,4,1961,527000
6762818466,1280,7,1280,0,5,1923,525000
6762818611,910,7,910,0,2,1924,520000
6762818838,1560,7,1560,0,4,1965,511100
6762819873,2090,8,1200,890,3,1969,478500
6762820085,1780,8,1330,450,5,1976,472000
6762820179,1220,6,1090,130,5,1921,469950
6762820198,1390,8,1140,250,3,2005,469000
6762820381,1090,6,1090,0,1,1924,463500
6762820400,1690,7,1690,0,2,1906,462500
6762820634,1350,8,1350,0,2,2004,455000
6762820844,1030,7,1030,0,2,1942,450000
6762821674,2360,7,2360,0,3,2003,430000
6762821675,1040,8,1040,0,2,2008,430000
6762821900,1960,7,1400,560,3,1982,425000
6762822318,2891,9,2891,0,4,2014,415000
6762823065,2020,7,1620,400,4,1959,397000
6762823587,2980,8,2980,0,4,2003,382500
6762824087,2110,8,2110,0,3,1985,370000
6762824750,1770,7,1770,0,4,2004,353500
6762824908,1300,6,1300,0,3,1971,350000
6762825224,1470,6,1470,0,3,1932,344950
6762825281,1260,7,1040,220,3,2003,342000
6762825800,1430,7,1430,0,3,1948,330000
6762825892,2475,7,2475,0,4,2014,329900
6762825909,2570,8,2570,0,5,1996,329000
6762826209,1710,8,1710,0,3,1964,322400
6762826213,2200,7,1250,950,3,1964,322000
6762826455,1160,7,1160,0,3,1966,315500
6762826714,860,6,860,0,2,1921,310000
6762827129,2080,7,1450,630,4,1968,300000
6762827380,1220,7,1220,0,3,1982,295000
6762828214,1030,7,1030,0,3,1968,275000
6762828368,1490,6,970,520,4,1940,271000
6762829041,910,5,910,0,3,1943,255000
6762829110,940,7,940,0,3,1958,253905
6762829489,820,6,820,0,2,1945,245000
6762829833,1200,7,1200,0,3,1960,235000
6762830338,820,8,760,60,1,2007,219500
6762830507,1830,5,1830,0,3,1930,212000
6762831177,920,8,920,0,2,1980,176000
6762831254,1040,6,1040,0,3,1947,170000
6762810253,4280,11,4280,0,4,1984,1930000
6762810388,5290,11,4540,750,3,1988,1690000
6762810397,5170,11,3520,1650,5,1998,1680000
6762810456,3680,9,2480,1200,4,1936,1600000
6762810559,3730,10,2810,920,4,2006,1490000
6762810757,2470,9,1890,580,4,1906,1330000
6762810758,2360,8,2080,280,3,1913,1330000
6762810883,4360,11,3400,960,4,2007,1260000
6762811047,2510,10,2510,0,3,2006,1190000
6762811095,1640,8,1640,0,3,1968,1160000
6762811322,4460,11,4460,0,4,2001,1060000
6762811323,2990,10,2990,0,4,2014,1060000
6762811446,2700,8,2700,0,4,2002,1020000
6762811520,1570,8,1570,0,2,1914,998500
6762812402,4370,10,2580,1790,4,1978,858000
6762812523,2440,8,1440,1000,4,1950,849000
6762812878,3520,10,3520,0,4,1991,810000
6762813348,3230,9,3230,0,4,2004,772500
6762813376,1900,8,1450,450,3,1948,770000
6762813534,1980,8,1520,460,3,1949,759000
6762813567,2930,8,2930,0,3,2013,754842
6762814301,1650,7,1650,0,2,1916,705000
6762814328,1370,8,1130,240,2,1941,703011
6762814565,1970,7,1970,0,4,1909,690000
6762814994,1930,7,1490,440,3,1929,665000
6762815069,1750,8,1750,0,3,1956,660000
6762815162,1370,7,1070,300,3,1939,655000
6762815163,3340,8,2060,1280,4,1977,655000
6762815556,1010,7,1010,0,3,1919,636100
6762815724,1560,7,1560,0,4,1923,627500
6762815796,1660,7,1660,0,3,1906,625000
6762815797,1600,8,1250,350,3,1906,625000
6762815908,2850,8,2120,730,4,1999,620000
6762816699,1700,9,1320,380,3,2002,585000
6762817079,2340,7,1170,1170,4,1924,570000
6762817139,2150,8,2150,0,3,1995,569000
6762818038,1900,7,1200,700,2,1919,539000
6762818612,2734,8,2734,0,4,1974,520000
6762818870,2750,7,1870,880,3,1981,510000
6762819137,1530,8,1240,290,3,2007,500000
6762819371,2080,7,1040,1040,3,1925,495000
6762819879,1200,7,600,600,2,1924,478000
6762820295,1730,7,880,850,4,1956,465000
6762820738,1530,7,1530,0,3,1998,452000
6762820845,2530,8,2530,0,3,2001,450000
6762820846,2410,7,2410,0,3,2007,450000
6762821262,1190,7,990,200,2,1917,440000
6762821263,1230,8,1230,0,3,2009,440000
6762821344,800,7,800,0,2,1945,439000
6762821428,1800,8,1800,0,3,1983,436000
6762821740,1992,6,1288,704,2,1903,429592
6762821808,1440,8,1100,340,2,2011,427000
6762821901,1790,8,1790,0,3,1937,425000
6762822018,1830,7,1830,0,3,1951,423000
6762822041,990,7,990,0,3,1948,421500
6762822043,1440,7,1440,0,3,2003,421200
6762822092,1130,7,940,190,3,1946,420000
6762822423,1040,7,1040,0,2,1901,412000
6762822424,1200,9,1200,0,3,2010,412000
6762823447,2740,7,2740,0,5,1990,386000
6762823896,2250,8,2250,0,4,2012,375000
6762825119,1070,7,880,190,2,1917,346000
6762825351,2690,9,2690,0,3,1987,340000
6762825602,2154,8,2154,0,4,2012,335000
6762825801,1160,6,580,580,2,1963,330000
6762826284,1400,7,1400,0,3,1959,320000
6762826500,2180,7,1100,1080,4,1954,315000
6762826501,2040,8,2040,0,4,2003,315000
6762826715,1490,7,1490,0,3,1959,310000
6762826924,1680,7,1680,0,3,1993,305000
6762826925,1290,7,1290,0,3,2008,305000
6762827225,1210,9,920,290,3,2008,299900
6762827381,1460,7,1460,0,3,1995,295000
6762827443,2190,8,2190,0,4,2005,294000
6762827699,1250,7,1250,0,3,1965,287000
6762827863,2130,7,1560,570,4,1992,283000
6762827864,1740,7,1270,470,3,1947,283000
6762827961,1880,7,1120,760,4,1974,280000
6762828645,1860,7,1860,0,4,1955,265000
6762828748,1610,7,1610,0,3,1961,262500
6762829177,1650,7,860,790,4,1972,251000
6762829891,1140,6,1140,0,3,1967,234000
6762830092,860,6,860,0,2,1943,227000
6762830381,1860,7,1860,0,3,1967,217000
6762830566,830,6,830,0,2,1940,210000
6762831326,760,6,760,0,2,1920,162500
6762810343,5790,10,4430,1360,5,2014,1750000
6762810560,3930,10,3310,620,4,2007,1490000
6762810810,3470,9,2480,990,4,1927,1300000
6762812826,3040,8,2350,690,4,2013,815000
6762813377,3260,8,3260,0,7,1967,770000
6762813633,3190,9,3190,0,4,2005,750000
6762814010,3440,9,3440,0,4,1982,725000
6762814302,2830,8,1430,1400,6,1967,705000
6762814640,1660,7,1280,380,4,1928,685000
6762815164,3110,9,3110,0,4,1997,655000
6762815209,2130,7,1330,800,3,1925,652000
6762815961,1260,7,1260,0,4,1911,618000
6762816482,3370,9,3370,0,3,2004,595000
6762816700,1740,8,1130,610,3,1995,585000
6762816819,3280,8,2270,1010,4,1986,580000
6762817034,2770,8,2770,0,4,2014,572000
6762818150,1960,8,1960,0,3,1978,535000
6762818335,3030,8,2600,430,5,1961,529900
6762818467,2520,9,2520,0,4,1994,525000
6762818468,2530,8,2530,0,4,1998,525000
6762818469,2530,7,1700,830,4,1942,525000
6762818470,2120,8,1260,860,3,1981,525000
6762818871,2730,9,1740,990,4,1996,510000
6762819372,1670,7,1670,0,2,1930,495000
6762819499,4480,7,3680,800,4,2003,490000
6762819653,1620,7,1620,0,4,1923,485000
6762819725,2130,8,1370,760,3,1976,482975
6762819795,1920,7,1920,0,4,1964,480000
6762820467,2870,9,2070,800,4,2006,460000
6762820596,2220,8,1270,950,4,1978,456000
6762820964,1260,7,1260,0,3,2005,449500
6762821388,2670,8,1610,1060,4,1975,437850
6762821725,1830,8,1300,530,3,1977,429950
6762821775,2120,7,1280,840,3,1979,428000
6762821776,2340,7,2340,0,3,2004,428000
6762821902,1170,7,1030,140,2,1920,425000
6762822210,1980,7,1080,900,5,1929,418000
6762822660,1170,8,1170,0,2,2001,405000
6762822860,900,7,900,0,3,1910,400000
6762823759,1380,8,1380,0,3,2006,379000
6762823897,1130,8,1000,130,2,2006,375000
6762824234,1790,8,1790,0,3,2009,366000
6762824670,1120,6,860,260,3,1948,355000
6762824764,2190,7,1390,800,3,1953,353000
6762825108,2150,7,1290,860,4,1991,346500
6762825352,1680,7,840,840,4,1979,340000
6762825443,1930,7,1930,0,4,1994,339500
6762826502,1570,7,1570,0,3,2003,315000
6762826716,1290,6,1290,0,3,1950,310000
6762826817,1680,8,1200,480,3,1977,308000
6762826992,1320,7,1320,0,2,1996,304000
6762827130,1730,5,1730,0,4,1948,300000
6762827271,2050,8,2050,0,4,1977,299000
6762827486,1270,7,1270,0,3,2007,292000
6762827686,1810,7,1130,680,3,1954,287500
6762827791,1100,7,780,320,3,2008,285000
6762827843,1660,7,1660,0,3,2013,284000
6762827962,2080,6,1040,1040,3,1970,280000
6762828215,1430,5,1430,0,4,1934,275000
6762828421,1900,7,1900,0,4,1968,270000
6762828540,1980,8,1180,800,3,1978,268000
6762828646,1070,6,970,100,3,1947,265000
6762828647,1400,7,1400,0,3,2013,265000
6762828741,1830,7,1250,580,4,1979,263000
6762829403,1530,7,1530,0,3,1995,247500
6762829490,1700,7,1700,0,3,1996,245000
6762829593,2340,7,1170,1170,5,1951,242000
6762829647,1830,7,1830,0,4,1991,240000
6762830232,990,7,990,0,3,1972,222500
6762830630,1810,7,1810,0,4,1962,208000
6762831160,990,7,990,0,2,1977,179000
6762831228,1740,6,1050,690,2,1947,173000
6762831535,500,5,500,0,1,1928,125000
6762810092,3990,11,3990,0,4,1989,2720000
6762810389,4020,11,4020,0,4,2001,1690000
6762810457,5130,11,5130,0,5,1996,1600000
6762810852,3720,9,1960,1760,4,1947,1280000
6762812205,3560,10,3560,0,4,2014,882990
6762812405,2040,8,2040,0,3,1928,857500
6762812449,2660,8,1330,1330,3,1971,851000
6762813429,2660,9,2660,0,4,2003,765000
6762813430,2120,7,1980,140,3,1920,765000
6762813634,2850,9,2850,0,4,2008,750000
6762813719,2560,7,1280,1280,3,1911,747000
6762814124,2930,9,2930,0,5,2013,718000
6762815210,1920,8,1560,360,3,1968,652000
6762815526,1990,10,1990,0,4,1989,639000
6762815909,2410,8,2410,0,3,1980,620000
6762816103,5450,9,5450,0,4,1984,610000
6762816450,2420,7,2420,0,4,2001,597400
6762816510,2780,9,2780,0,3,2013,594866
6762816532,2080,7,2080,0,4,1925,592500
6762817282,2320,8,2320,0,4,1991,562500
6762817522,1400,8,940,460,2,2006,553000
6762817978,1840,7,920,920,4,1918,540000
6762818386,1310,7,1170,140,3,1928,526500
6762818471,3130,9,3130,0,4,2008,525000
6762818613,1480,8,1480,0,3,2006,520000
6762818676,2440,8,1440,1000,4,1966,518000
6762819138,2630,7,1690,940,4,1976,500000
6762819907,1850,7,1600,250,4,2005,476100
6762819919,1500,8,1500,0,3,1952,475500
6762820847,2290,8,1390,900,3,1981,450000
6762821417,2708,9,2708,0,4,2014,436952
6762821734,2584,8,2584,0,4,2014,429900
6762822319,2650,7,1590,1060,3,1962,415000
6762822425,1240,6,860,380,2,1909,412000
6762822998,1880,8,1420,460,3,1958,399000
6762823286,2680,8,2680,0,4,1986,390000
6762823615,2130,8,2130,0,4,2003,381000
6762823898,1430,7,1430,0,4,1948,375000
6762824017,2430,8,2430,0,3,2001,372000
6762824736,1390,6,1390,0,2,1925,354000
6762824909,2300,6,1340,960,4,1966,350000
6762824910,3390,7,1970,1420,4,1961,350000
6762825603,1030,6,880,150,3,1948,335000
6762825604,1480,7,1480,0,4,1914,335000
6762825723,1340,7,1340,0,3,1978,332000
6762826049,1270,8,1270,0,3,2009,325000
6762826285,1760,8,1760,0,4,1968,320000
6762826717,1050,6,780,270,2,1947,310000
6762826993,1720,7,1000,720,3,1954,304000
6762827382,820,6,820,0,2,1930,295000
6762827558,1500,7,1210,290,3,1968,290000
6762827792,1870,7,1870,0,3,1953,285000
6762828216,1720,6,860,860,4,1923,275000
6762828312,1180,6,590,590,2,1945,273000
6762828541,1610,7,1610,0,3,1994,268000
6762828648,1530,7,1530,0,3,1986,265000
6762828837,1410,6,1410,0,2,1918,260000
6762829093,780,6,780,0,2,1953,254922
6762829339,1500,7,1500,0,4,1983,249900
6762829984,1630,7,980,650,3,1980,230000
6762830493,750,6,750,0,2,1937,213000
6762830567,1000,7,1000,0,3,1954,210000
6762831069,1170,7,1170,0,3,1967,185000
6762831070,940,7,940,0,3,1958,185000
6762831308,1020,6,1020,0,3,1959,165000
6762831370,1710,7,1710,0,5,1961,158550
6762831540,840,6,840,0,1,1949,124000
6762813635,2100,8,2100,0,4,1909,750000
6762824818,1210,8,1210,0,2,2014,351358
6762825744,580,7,580,0,1,1908,330600
6762830846,1550,7,1550,0,3,1949,199950
6762820358,2040,8,1260,780,4,1974,464625
6762829183,1290,6,1170,120,3,1943,250800
6762831269,1300,7,1300,0,3,1968,169575
6762810436,4250,12,3020,1230,4,1996,1620000
6762810609,3720,9,2720,1000,4,1905,1440000
6762811123,4350,10,3520,830,5,2007,1150000
6762811124,4090,9,3100,990,6,1984,1150000
6762811165,3100,11,3100,0,6,1978,1130000
6762811447,2720,8,1790,930,4,1928,1020000
6762812689,3430,10,3430,0,4,1992,829950
6762812726,3400,8,1870,1530,3,1955,825000
6762812727,2080,8,2080,0,3,1906,825000
6762813027,3320,9,3320,0,4,2014,799950
6762813311,3290,9,2670,620,5,2004,775000
6762813470,3190,9,3190,0,3,1988,760750
6762813835,3200,9,3200,0,4,1993,737500
6762813918,4420,10,3350,1070,4,2004,730000
6762814303,2620,8,1520,1100,4,1979,705000
6762814822,3320,9,3320,0,4,2001,675000
6762815185,2220,10,2010,210,3,2012,654000
6762815527,1940,7,980,960,4,1910,639000
6762816625,2360,8,2360,0,3,1981,589000
6762816868,1710,8,1140,570,3,2003,579000
6762817041,2810,8,1860,950,4,1959,571500
6762817523,3160,9,3160,0,3,2005,553000
6762817641,1080,7,780,300,2,1922,550000
6762817642,2420,8,1680,740,4,1988,550000
6762817735,2680,8,2680,0,3,2001,549950
6762818151,2400,9,2400,0,3,1983,535000
6762818282,1390,8,970,420,2,1954,530000
6762818331,1500,8,1140,360,2,2014,529950
6762818582,1460,8,1460,0,3,2000,521000
6762818687,1410,7,740,670,3,1908,517950
6762818872,2440,7,2440,0,4,1955,510000
6762819000,1995,8,1760,235,3,2005,505000
6762819796,1680,7,840,840,3,1952,480000
6762820224,2040,7,2040,0,3,1997,467500
6762820509,2350,8,2350,0,4,2014,459995
6762821345,1350,9,870,480,2,2004,439000
6762821581,1940,8,1340,600,3,1979,432500
6762821755,1860,8,1860,0,3,1994,429000
6762822093,1750,7,1750,0,4,1954,420000
6762822223,2270,7,1340,930,5,1995,417500
6762822780,1470,8,1470,0,3,1955,401000
6762822861,1810,7,1810,0,4,1997,400000
6762823051,1350,8,1050,300,3,2007,397500
6762823130,2100,7,1060,1040,5,1961,395000
6762823287,1870,6,1350,520,2,1926,390000
6762823732,1140,6,1140,0,2,1925,379900
6762823796,1370,7,1130,240,3,1926,377500
6762824280,2070,8,2070,0,4,1986,365000
6762824789,2300,7,1840,460,4,1958,352500
6762824911,1320,7,1320,0,3,1966,350000
6762825898,1080,7,1080,0,3,1947,329500
6762826050,2480,8,2480,0,3,1979,325000
6762826148,1040,7,1040,0,3,1959,324950
6762826286,2300,7,2300,0,4,2012,320000
6762826718,720,6,720,0,2,1943,310000
6762827131,2000,7,2000,0,5,1968,300000
6762827320,2230,8,2230,0,4,2011,297000
6762827383,2350,7,2350,0,4,1993,295000
6762827384,1710,7,1030,680,4,1975,295000
6762827454,2120,7,1370,750,4,1965,293550
6762827559,1020,7,1020,0,2,1930,290000
6762828649,1460,7,1460,0,3,1955,265000
6762829491,1900,7,1250,650,3,1967,245000
6762829492,2100,7,2100,0,3,1954,245000
6762830214,1150,6,1060,90,2,1930,224000
6762830442,1290,7,1290,0,3,1947,215000
6762830653,2100,6,2100,0,4,1914,207000
6762830891,1090,7,1090,0,3,1962,197000
6762830992,1320,7,1320,0,3,1987,190000
6762810042,5450,11,5450,0,5,2014,3420000
6762810199,4340,8,4340,0,8,1967,2150000
6762810589,3940,9,2140,1800,3,1967,1450000
6762810702,5310,11,5310,0,4,1989,1370000
6762810954,2860,8,1980,880,3,1915,1230000
6762811064,3960,10,3960,0,5,1998,1180000
6762811256,2920,8,2920,0,3,1950,1090000
6762811426,5050,11,5050,0,5,2001,1030000
6762812236,3480,11,3480,0,4,1995,878000
6762812383,4040,9,3220,820,4,2006,860000
6762812988,7480,11,5080,2400,7,1953,800000
6762813258,2990,9,2990,0,4,2014,779950
6762813360,2390,8,1430,960,4,1979,770126
6762813636,2180,8,2180,0,2,1934,750000
6762813898,2360,9,2360,0,4,1974,732000
6762814135,2540,8,2540,0,4,2009,717000
6762814203,2280,7,1340,940,5,1947,712500
6762814369,1620,8,1320,300,2,1948,700000
6762814566,2070,8,1340,730,3,1955,690000
6762815280,3900,8,2870,1030,6,1979,650000
6762815712,1900,8,1280,620,4,1984,629000
6762816176,1970,8,1130,840,3,1950,606000
6762816820,2430,7,1730,700,4,1928,580000
6762816854,1420,8,1180,240,3,2003,579950
6762817042,2180,8,2180,0,4,1993,571500
6762817140,2830,8,2830,0,4,2003,569000
6762817213,1740,7,1040,700,2,1907,565000
6762817214,1710,7,1710,0,4,1907,565000
6762817405,1930,8,1930,0,2,2006,559000
6762817474,3050,8,1650,1400,4,1966,555000
6762817643,3000,8,1500,1500,5,1966,550000
6762817848,2140,8,2140,0,3,1990,545000
6762817979,1940,7,1940,0,5,1940,540000
6762818019,2910,8,2130,780,4,1966,539950
6762818374,2530,7,2530,0,5,1961,527500
6762818393,1450,7,1450,0,2,1921,526000
6762818651,2403,9,2403,0,4,1999,519900
6762818677,2830,8,2830,0,4,1993,518000
6762818873,3530,10,3530,0,4,1992,510000
6762819001,2280,7,1340,940,4,1978,505000
6762819053,1570,8,1570,0,2,1931,502000
6762819139,960,6,960,0,3,1944,500000
6762819457,2005,7,1605,400,3,1980,491000
6762819583,1830,7,1830,0,4,1963,488250
6762819654,1130,7,960,170,3,1939,485000
6762819979,2280,8,1550,730,3,1990,475000
6762820427,3202,9,3202,0,4,2014,460940
6762820468,2560,7,1970,590,3,1959,460000
6762820533,1160,8,1160,0,3,2008,459000
6762820951,1540,7,1540,0,3,2014,449950
6762820997,2560,7,1480,1080,4,1979,448000
6762821264,2350,7,1510,840,3,1978,440000
6762821346,1680,7,1680,0,3,2011,439000
6762821557,1660,7,1660,0,3,1955,434000
6762821676,1610,8,1310,300,3,1960,430000
6762821903,1330,7,1330,0,4,1928,425000
6762822495,1860,8,1860,0,3,1997,410000
6762822862,1370,7,1370,0,3,1977,400000
6762822863,1450,8,1450,0,3,1984,400000
6762822864,2070,7,1080,990,5,1958,400000
6762822999,1800,7,1690,110,3,2004,399000
6762823203,740,6,740,0,2,1924,392800
6762823288,1930,7,1930,0,3,1969,390000
6762823496,1750,7,1750,0,5,1961,385000
6762823616,1470,7,1470,0,3,2003,381000
6762823899,2420,7,2420,0,4,2003,375000
6762824744,3260,8,3260,0,5,1982,353950
6762824746,1560,6,780,780,3,1927,353900
6762825353,1730,6,1730,0,3,1918,340000
6762825605,1060,7,760,300,2,2003,335000
6762825962,1370,8,1370,0,3,2009,327000
6762826149,1150,7,1150,0,2,1946,324950
6762826503,1030,6,1030,0,2,1952,315000
6762826504,1240,7,1150,90,2,2009,315000
6762826926,2230,7,2230,0,4,2003,305000
6762827272,1520,6,1520,0,3,1953,299000
6762827321,1340,7,1340,0,3,1924,297000
6762827385,1660,7,1660,0,3,2011,295000
6762827560,2060,7,1350,710,3,1987,290000
6762828422,1230,7,1230,0,3,1962,270000
6762828650,760,6,760,0,2,1950,265000
6762828838,1960,7,1960,0,4,2003,260000
6762828889,770,6,770,0,2,1948,259950
6762828937,2090,6,1200,890,3,1986,258000
6762829042,1410,7,1410,0,3,1960,255000
6762829129,2020,7,1310,710,3,1994,253000
6762829247,930,6,930,0,3,1973,250000
6762829648,1470,7,1470,0,3,1969,240000
6762829649,2020,7,1010,1010,4,1954,240000
6762830049,1810,7,1810,0,3,1954,229500
6762831033,550,4,550,0,1,1945,188000
6762810178,3760,11,2830,930,3,2014,2230000
6762810903,2310,9,2310,0,2,2006,1250000
6762811018,3900,9,2650,1250,5,2014,1200000
6762811464,2160,10,2160,0,3,1982,1010000
6762811494,2300,8,1150,1150,3,1963,1000000
6762811658,3840,9,3840,0,3,1996,970000
6762811828,2450,8,1960,490,3,1933,939000
6762812007,2890,8,2090,800,4,1939,910000
6762812190,4470,10,4470,0,4,1991,885000
6762812422,3440,10,3440,0,3,1985,855000
6762812486,1400,7,1400,0,3,1951,850000
6762812929,2910,9,2910,0,4,1989,805000
6762813119,3500,9,3500,0,4,2004,790000
6762813142,3240,9,3240,0,4,2010,789500
6762813171,3370,8,1920,1450,4,1977,785000
6762813431,2700,10,2700,0,3,1992,765000
6762813496,2960,10,2960,0,4,1989,760000
6762814150,2410,8,1540,870,3,1965,715500
6762814211,2450,10,2450,0,4,1979,712000
6762815033,2500,9,2500,0,3,1984,662000
6762815165,2570,9,2570,0,4,2001,655000
6762816247,1790,7,1400,390,3,1943,603000
6762816264,1840,8,1840,0,2,2001,601450
6762816742,1790,8,1790,0,3,1992,584000
6762816887,2140,8,1220,920,3,1964,577500
6762816898,2070,7,1260,810,2,1946,577000
6762817080,3230,9,3230,0,4,2008,570000
6762817253,1990,8,1990,0,3,1991,564800
6762817352,1140,8,1140,0,3,1931,560000
6762817353,1560,8,1180,380,3,2006,560000
6762817425,3350,8,2670,680,3,2014,557500
6762817980,2329,9,2329,0,4,1995,540000
6762818583,1870,7,1060,810,3,1926,521000
6762818747,2470,8,1470,1000,4,1975,515000
6762818748,1560,8,1560,0,3,2014,515000
6762819140,2490,8,2490,0,4,1981,500000
6762819244,2880,8,1710,1170,3,1970,499950
6762819311,2170,7,1230,940,5,1959,497500
6762819729,1170,9,1170,0,2,2007,482500
6762819862,1710,8,1710,0,3,1982,479000
6762819980,1640,8,1640,0,3,1929,475000
6762820296,910,7,780,130,3,1942,465000
6762820635,1870,7,1870,0,3,1950,455000
6762820848,1640,7,820,820,4,1912,450000
6762821790,2430,8,2430,0,4,2010,427500
6762822094,1770,8,1770,0,3,1999,420000
6762822261,1310,7,1310,0,3,1964,415885
6762822320,1510,6,860,650,3,1940,415000
6762822953,2050,7,1170,880,3,1960,399950
6762822954,1720,7,1720,0,3,1954,399950
6762823131,1960,7,980,980,4,1946,395000
6762823381,1380,7,1380,0,3,1947,389000
6762823497,770,6,770,0,2,1946,385000
6762823781,1650,8,1650,0,3,2007,378000
6762823900,2680,8,1810,870,5,1990,375000
6762824188,2500,7,1540,960,4,1972,368000
6762824281,1820,7,1380,440,4,1955,365000
6762824447,1970,7,1070,900,3,1979,360000
6762824828,1770,7,1770,0,2,2003,350500
6762825017,1420,8,1420,0,3,2002,349950
6762825716,2660,8,1980,680,5,1996,332100
6762825802,880,7,880,0,2,1945,330000
6762827963,1370,7,1370,0,3,1980,280000
6762828159,890,7,890,0,2,1947,275400
6762828423,2701,7,2701,0,4,2013,270000
6762828542,1850,7,1850,0,3,1986,268000
6762829248,1360,7,1360,0,3,1978,250000
6762830208,1420,6,1420,0,3,1962,224097
6762830654,1980,7,1280,700,3,1943,207000
6762830771,980,7,980,0,3,1969,201000
6762830964,1420,7,1420,0,3,1986,192500
6762831022,800,6,800,0,2,1955,189900
6762831103,1740,7,1240,500,3,1978,182700
6762831180,1450,6,1450,0,4,1969,175409
6762831348,1370,7,1370,0,3,1990,160000
6762810117,4300,11,4300,0,4,1985,2500000
6762810304,6380,12,6380,0,4,2006,1820000
6762810533,4010,11,2600,1410,3,1983,1510000
6762810626,3600,11,3310,290,4,1991,1420000
6762810649,4300,10,2910,1390,5,1957,1400000
6762810710,2310,10,2310,0,3,1979,1360000
6762811605,2240,8,2240,0,4,1976,980000
6762811670,2080,8,1220,860,3,1984,969500
6762811768,3230,9,3230,0,4,1999,950000
6762812159,2590,8,2310,280,5,1907,890000
6762812487,1910,9,1910,0,3,1900,850000
6762812810,3600,10,2680,920,5,2005,817500
6762813637,3170,10,3170,0,4,1992,750000
6762814011,1790,7,1790,0,3,1903,725000
6762814140,3630,11,3630,0,5,2000,716500
6762814823,3190,8,2120,1070,4,1999,675000
6762815281,2640,7,1500,1140,4,1966,650000
6762816061,1690,7,1690,0,4,1967,612500
6762816171,1800,8,1500,300,3,1929,606400
6762816821,2180,7,1380,800,6,1926,580000
6762816855,3080,9,3080,0,5,2014,579950
6762816959,1720,8,1720,0,3,1981,575000
6762817215,2280,8,2280,0,4,1986,565000
6762817354,2790,8,1700,1090,3,1955,560000
6762817801,2130,8,2130,0,3,1990,546500
6762817892,1270,7,990,280,3,1970,543500
6762818206,2810,8,2810,0,3,2004,533000
6762818367,1760,7,880,880,4,1926,527950
6762818472,1970,8,1970,0,3,1968,525000
6762818874,1845,8,1845,0,3,1947,510000
6762818875,1990,7,1990,0,3,1971,510000
6762818963,1670,8,1670,0,2,2004,507000
6762819141,1730,8,1290,440,3,1988,500000
6762819981,2340,7,1300,1040,5,1975,475000
6762820534,2790,9,2790,0,4,2000,459000
6762820636,3080,8,2310,770,5,2003,455000
6762820720,2240,7,2240,0,3,2002,452500
6762820965,2430,8,1310,1120,4,1961,449500
6762821265,1480,7,1480,0,4,1940,440000
6762821347,2240,8,2240,0,4,1978,439000
6762822003,1820,8,1820,0,3,1985,424000
6762822004,1580,8,1580,0,3,1955,424000
6762822661,1960,7,1960,0,3,2006,405000
6762822763,710,7,710,0,2,1905,402000
6762822865,3000,8,1500,1500,3,1962,400000
6762822866,3140,9,3140,0,4,1977,400000
6762822867,1000,6,860,140,3,1930,400000
6762823901,1757,7,1757,0,4,1955,375000
6762824671,1980,8,1300,680,3,1964,355000
6762824829,1450,7,1450,0,2,1967,350500
6762825018,1780,7,890,890,4,1903,349950
6762825049,1640,7,1640,0,3,1989,349000
6762825445,1590,7,1080,510,3,1964,339275
6762825606,2000,7,1390,610,4,1961,335000
6762826664,2020,7,1220,800,5,1993,311000
6762826850,730,5,730,0,1,1945,306950
6762827132,1910,8,1910,0,4,1992,300000
6762827561,440,5,440,0,2,1943,290000
6762827562,1480,6,1380,100,3,1942,290000
6762827700,2240,7,2240,0,4,2005,287000
6762827701,930,7,930,0,2,1952,287000
6762828028,1930,7,1330,600,3,1977,279950
6762828144,870,7,820,50,2,2004,276000
6762828578,1440,8,1440,0,3,1977,267000
6762828749,1470,7,1470,0,3,1989,262500
6762828954,1690,7,1210,480,3,1955,257500
6762829043,920,5,920,0,2,1923,255000
6762829130,1030,7,1030,0,3,1960,253000
6762829326,1330,6,1330,0,4,1952,249950
6762829493,1460,7,1460,0,3,1989,245000
6762829650,1450,7,1450,0,3,1963,240000
6762829651,720,6,720,0,2,1943,240000
6762829834,2070,7,1060,1010,4,1964,235000
6762830098,930,6,930,0,2,1957,226950
6762830443,810,6,810,0,3,1942,215000
6762830702,1850,7,1850,0,4,1972,205000
6762831402,1240,7,1240,0,2,1986,153503
6762831417,1060,6,1060,0,2,1954,151600
6762831528,910,7,910,0,3,1955,128000
6762810327,4890,13,4890,0,4,2004,1780000
6762810650,2560,9,2110,450,3,1967,1400000
6762810811,2130,8,1500,630,5,1968,1300000
6762810884,3220,10,2760,460,3,1991,1260000
6762811276,2830,11,2830,0,3,2001,1080000
6762811684,5010,9,3710,1300,4,1978,965000
6762811980,3490,9,1840,1650,5,1958,915000
6762812309,2650,9,2650,0,4,1984,870000
6762812384,2600,8,1700,900,3,1967,860000
6762813028,3760,9,2780,980,5,2014,799950
6762813043,2550,9,2550,0,3,2007,799000
6762813172,3200,9,3200,0,4,1972,785000
6762813231,1620,8,1620,0,3,1949,780000
6762813312,1010,7,1010,0,2,1913,775000
6762813342,2420,8,2420,0,3,1969,774888
6762813474,2540,7,1440,1100,5,1953,760250
6762813497,2660,7,1670,990,5,1922,760000
6762813498,3040,9,1940,1100,4,1978,760000
6762814012,3360,8,2640,720,5,1963,725000
6762814246,2780,8,2780,0,4,2001,710000
6762814370,1160,6,1160,0,2,1945,700000
6762814476,2450,7,1550,900,4,1920,696950
6762814522,2090,8,1280,810,3,1952,693000
6762814567,3370,8,2140,1230,5,1988,690000
6762814568,2480,9,1890,590,3,1929,690000
6762814641,3160,9,3160,0,5,2003,685000
6762815025,2840,7,1580,1260,3,1967,663000
6762815867,1950,8,1950,0,3,1987,622000
6762815968,1880,7,1880,0,3,1947,617000
6762816012,2500,8,1600,900,4,1975,615000
6762816104,1000,8,1000,0,3,1945,610000
6762816105,1650,7,1650,0,3,1992,610000
6762816148,2240,7,1220,1020,3,1952,608000
6762816203,1880,7,1080,800,4,1926,605000
6762816573,2490,8,2490,0,4,2002,590000
6762816960,1710,7,1590,120,3,1909,575000
6762818093,1580,7,1280,300,3,1945,536000
6762818473,1820,7,1820,0,4,1960,525000
6762819500,2380,8,2040,340,3,1961,490000
6762819501,3080,9,3080,0,3,2006,490000
6762819555,2480,8,1800,680,3,1976,489950
6762819982,3660,10,2660,1000,4,1994,475000
6762819983,2410,7,1210,1200,4,1969,475000
6762819984,1320,7,1080,240,2,1955,475000
6762820055,1140,6,770,370,3,1944,474000
6762820147,1740,7,1740,0,4,1932,470000
6762820180,2310,7,1300,1010,5,1975,469950
6762820637,1270,7,1270,0,3,1968,455000
6762821090,1730,8,1730,0,3,1996,445000
6762821091,1310,8,1120,190,3,2002,445000
6762821677,1720,7,1020,700,3,1970,430000
6762822186,3010,9,3010,0,4,2005,419000
6762822496,1660,7,960,700,3,1982,410000
6762822555,3140,7,2300,840,4,1992,409000
6762822718,700,6,700,0,1,1945,403500
6762822868,1520,7,1520,0,2,1999,400000
6762823132,2030,8,2030,0,3,1977,395000
6762823617,2700,7,1510,1190,3,1967,381000
6762824176,2510,9,2510,0,2,1977,368500
6762824529,2030,7,1450,580,4,1968,359500
6762824912,1860,7,1860,0,3,1966,350000
6762825086,1970,7,1970,0,4,2007,347500
6762825803,1160,7,1160,0,3,1967,330000
6762826051,970,7,970,0,2,1983,325000
6762826287,2630,8,2630,0,5,1966,320000
6762826403,1250,8,1250,0,3,2008,318000
6762826404,1250,7,1250,0,3,1970,318000
6762826665,1310,7,1310,0,3,1962,311000
6762826813,2300,7,1650,650,4,1959,308130
6762827487,2130,7,1370,760,4,1952,292000
6762827682,1050,7,1050,0,3,1960,287653
6762827964,1100,6,840,260,3,1948,280000
6762827965,2110,7,1110,1000,5,1966,280000
6762827966,1360,7,1360,0,3,1981,280000
6762828342,1800,7,1800,0,4,2003,272000
6762828965,1740,8,1740,0,3,2009,257000
6762829044,1250,6,1250,0,3,1927,255000
6762829045,1900,7,1900,0,3,1958,255000
6762829547,910,5,910,0,2,1923,244500
6762829714,910,6,910,0,2,1983,239900
6762829985,770,6,770,0,2,1948,230000
6762830156,1080,6,1080,0,3,1952,225000
6762830240,1370,7,1370,0,3,1980,222000
6762830346,1050,7,1050,0,2,1984,219000
6762830508,770,6,770,0,2,1921,212000
6762831394,1010,5,1010,0,2,1990,155000
6762810039,5490,12,5490,0,5,2005,3640000
6762822869,1390,6,1390,0,1,1960,400000
6762813173,2960,9,2960,0,4,2005,785000
6762819985,1630,8,1630,0,3,1986,475000
6762829568,1730,7,1730,0,4,1959,243400
6762810020,12050,13,8570,3480,6,1910,7700000
6762810590,4380,10,3580,800,3,1952,1450000
6762810591,4360,12,4360,0,4,1998,1450000
6762810986,3330,9,2870,460,4,2004,1210000
6762811048,2080,8,1040,1040,2,1939,1190000
6762811610,2480,10,2380,100,4,1929,979700
6762811948,3810,10,3810,0,4,2003,920000
6762812557,2560,8,2150,410,3,1910,842500
6762813155,3280,10,3280,0,4,2007,785500
6762813313,3180,9,3180,0,4,1988,775000
6762813557,3110,9,3110,0,4,2004,755000
6762813888,3080,9,3080,0,4,2003,733000
6762814013,1550,7,1550,0,3,1964,725000
6762814247,2570,8,1620,950,5,1956,710000
6762814287,3280,9,2190,1090,4,1972,706000
6762814503,2790,9,2790,0,4,1999,695000
6762815282,2580,8,1660,920,4,1959,650000
6762815407,1240,7,1000,240,2,1920,645000
6762815492,2060,8,2060,0,4,1960,640000
6762815561,2210,8,1510,700,3,1976,635250
6762815798,2601,9,2601,0,4,1995,625000
6762815799,1760,7,1170,590,4,1948,625000
6762815856,2300,9,2300,0,4,1984,623000
6762816891,1730,8,1730,0,3,2014,577450
6762816915,1516,7,998,518,3,1925,575575
6762817406,3110,9,3110,0,3,2001,559000
6762817925,3118,9,3118,0,4,2014,541800
6762817981,2570,8,1580,990,5,2009,540000
6762818394,1320,7,1320,0,3,1913,526000
6762819373,2980,8,1910,1070,4,2007,495000
6762819458,1660,8,1660,0,3,1950,491000
6762819797,1760,8,1560,200,5,1959,480000
6762820094,3790,8,2120,1670,5,2001,471750
6762820148,1190,7,1190,0,2,1912,470000
6762820695,1710,7,1160,550,2,1951,453500
6762821494,1120,7,1120,0,3,1955,435000
6762821575,2210,8,2210,0,3,1998,432900
6762822444,2860,8,1430,1430,5,1947,411000
6762822870,1420,7,1420,0,4,1930,400000
6762823133,2740,9,2740,0,4,1990,395000
6762823191,1600,7,1600,0,3,1948,393500
6762823289,1940,7,1940,0,4,1962,390000
6762823382,850,6,850,0,2,1910,389000
6762823666,1760,7,880,880,4,1956,380000
6762824282,1990,8,1990,0,4,1968,365000
6762824448,930,6,930,0,2,1919,360000
6762824544,1650,7,1230,420,3,1985,359000
6762824598,1250,7,1250,0,3,1972,357000
6762825019,2632,8,2632,0,4,2013,349950
6762825171,540,5,540,0,1,1961,345000
6762825172,1390,7,1390,0,3,1979,345000
6762825804,700,6,700,0,2,1943,330000
6762826052,990,6,990,0,2,1953,325000
6762826232,1300,7,1300,0,4,1941,321000
6762826394,2320,8,2270,50,4,1973,318888
6762826927,900,5,900,0,1,1946,305000
6762827133,1960,7,1670,290,3,2012,300000
6762827563,1850,7,1850,0,4,1993,290000
6762829438,1400,6,1400,0,4,1930,246000
6762829986,1410,7,1410,0,3,1980,230000
6762830248,1180,7,1180,0,3,1955,221900
6762830621,960,5,960,0,3,1956,208950
6762830941,1560,6,1060,500,6,1913,194990
6762810031,7080,12,5760,1320,4,2008,4000000
6762810243,2510,10,2510,0,3,1968,1950000
6762810328,4320,10,2160,2160,3,1972,1780000
6762810610,2410,8,2410,0,4,1911,1440000
6762811125,4190,11,3150,1040,4,2000,1150000
6762811225,4560,9,4170,390,4,1995,1100000
6762811511,3310,9,2290,1020,4,2014,999950
6762811698,3340,11,3340,0,4,2013,962000
6762811949,2480,8,1240,1240,3,1948,920000
6762812111,2470,8,1480,990,2,1954,898000
6762812118,2660,8,2080,580,4,1917,896000
6762812488,2550,8,1750,800,4,1900,850000
6762812489,4200,9,3140,1060,5,2012,850000
6762812860,1870,8,1870,0,3,1960,811000
6762813499,3530,10,3530,0,3,1994,760000
6762813638,2100,7,1100,1000,4,1915,750000
6762814304,2060,8,1370,690,4,1954,705000
6762814332,3880,7,3880,0,4,2004,702000
6762814526,3420,9,1710,1710,3,1963,692500
6762814613,1280,8,1280,0,3,1904,687500
6762814714,2520,9,2520,0,4,2004,680000
6762814931,2330,8,1950,380,3,2014,669950
6762815361,1720,8,1030,690,3,2004,649000
6762815493,3150,7,2430,720,4,1915,640000
6762815513,2800,8,2800,0,5,2014,639983
6762815800,2020,8,1010,1010,4,1942,625000
6762815942,2210,8,1480,730,4,1912,619500
6762816065,1740,7,1740,0,3,1982,612000
6762816081,2520,9,2520,0,4,2014,610685
6762816106,2300,8,2300,0,4,1955,610000
6762816542,3230,9,2680,550,3,2014,591975
6762816626,2630,8,2630,0,4,1962,589000
6762816740,3220,9,3220,0,4,2009,584950
6762817310,1710,7,1360,350,3,1918,561000
6762817644,2480,8,1460,1020,4,1958,550000
6762817645,2330,8,1730,600,3,1930,550000
6762817905,2070,8,2070,0,3,1988,542950
6762817982,1640,7,840,800,2,1959,540000
6762818716,2074,8,2074,0,3,1997,515100
6762818749,1820,7,1420,400,4,1969,515000
6762818929,1480,7,930,550,2,1914,509250
6762818946,3320,8,2000,1320,4,1986,508000
6762819655,3220,8,2010,1210,4,1959,485000
6762820469,1790,8,1280,510,2,1928,460000
6762820638,1340,7,1340,0,4,1914,455000
6762821046,1320,7,1320,0,3,1947,445800
6762821092,1850,8,1850,0,3,1979,445000
6762821140,1920,8,1920,0,3,1972,443500
6762821189,1010,7,1010,0,2,1919,441500
6762821331,1300,8,1300,0,2,2005,439888
6762821904,1180,7,1180,0,3,1949,425000
6762822095,2370,9,2370,0,3,1993,420000
6762822096,1310,7,1310,0,3,1986,420000
6762822173,2710,8,2710,0,5,2014,419354
6762822724,1270,7,1270,0,3,1956,403000
6762822871,2350,7,2350,0,4,1999,400000
6762822984,1180,8,1180,0,2,2006,399500
6762823066,860,7,860,0,3,1927,397000
6762823290,2270,8,1740,530,3,1980,390000
6762823360,1580,8,1580,0,3,1966,389950
6762823413,1860,8,1860,0,3,2001,387500
6762823498,1350,7,1350,0,3,1969,385000
6762824088,1160,7,1160,0,3,1972,370000
6762824217,2350,8,2350,0,4,1997,367000
6762824449,1160,7,1160,0,3,1965,360000
6762824672,1480,7,1480,0,3,1991,355000
6762825173,2390,7,2390,0,4,2003,345000
6762825482,750,6,750,0,2,1934,338000
6762825893,980,8,980,0,2,2008,329900
6762826053,2963,9,2963,0,4,2006,325000
6762826348,1840,7,1370,470,3,1979,319990
6762826368,2500,7,1420,1080,4,1907,319500
6762826609,1630,7,930,700,4,1978,313000
6762827134,1914,8,1914,0,4,2009,300000
6762827322,1690,7,1690,0,3,2002,297000
6762827793,1630,7,1100,530,3,1968,285000
6762827967,1360,7,1360,0,3,1992,280000
6762828095,2290,7,2290,0,4,2004,278000
6762828367,830,7,830,0,2,2005,271115
6762828651,1010,6,1010,0,3,1969,265000
6762828750,1130,6,1130,0,3,1944,262500
6762828839,1510,7,1510,0,3,1991,260000
6762830157,700,6,700,0,2,1943,225000
6762830158,1650,8,1290,360,3,1986,225000
6762830354,1400,7,1400,0,4,1964,218500
6762830921,1070,7,1070,0,3,1969,195000
6762831468,1010,7,1010,0,3,1960,145000
6762831536,920,6,920,0,3,1961,125000
6762831606,900,6,900,0,3,1969,89000
6762810237,6200,11,5050,1150,5,1988,1960000
6762810290,5570,9,3860,1710,5,1952,1860000
6762810407,3520,9,1950,1570,4,1951,1660000
6762810408,4240,10,4240,0,4,2006,1660000
6762810515,4470,11,4470,0,5,2008,1540000
6762811019,2770,10,2770,0,4,1999,1200000
6762811126,2320,9,1920,400,2,1937,1150000
6762811198,3660,9,2840,820,4,2014,1110000
6762811303,2890,8,1790,1100,3,1941,1070000
6762811360,3830,9,3830,0,4,2014,1050000
6762811427,3680,10,3680,0,3,1994,1030000
6762812728,2430,8,2430,0,4,1979,825000
6762812827,2780,10,2780,0,3,1999,815000
6762813078,2890,10,2890,0,4,1997,795000
6762813432,2660,8,1860,800,4,1909,765000
6762813500,2770,7,1470,1300,4,1953,760000
6762813501,3980,9,3980,0,4,2006,760000
6762813639,3020,9,2540,480,4,1997,750000
6762813737,3400,10,3190,210,4,2006,745000
6762813811,4460,9,4460,0,3,2005,739500
6762813919,2920,9,2920,0,4,1999,730000
6762813920,3110,7,2010,1100,7,1914,730000
6762814995,3130,8,3130,0,4,2004,665000
6762815801,2160,8,1170,990,2,1925,625000
6762815868,1690,8,1370,320,3,2006,622000
6762815910,2980,9,2980,0,4,2001,620000
6762816107,2440,8,1560,880,4,1976,610000
6762816325,4410,9,2330,2080,5,2001,600000
6762816641,3110,8,3110,0,5,2007,588000
6762817569,2620,8,1520,1100,5,1975,550120
6762818152,2360,9,1920,440,4,1986,535000
6762818474,2540,7,1270,1270,4,1947,525000
6762818837,1480,7,740,740,4,1927,511200
6762819002,2980,8,1910,1070,4,2007,505000
6762819003,1430,8,1430,0,2,2009,505000
6762819142,1220,7,1220,0,3,1964,500000
6762819413,2220,8,2220,0,2,1970,494950
6762819880,1690,7,1210,480,4,1958,478000
6762819881,2780,8,2780,0,4,1989,478000
6762820065,1380,8,1380,0,3,2005,473000
6762821266,1920,7,960,960,4,1952,440000
6762821570,1710,7,1710,0,4,1950,433000
6762821905,1440,7,870,570,2,1952,425000
6762822097,2170,7,1570,600,4,1962,420000
6762822378,1570,8,1570,0,3,2008,414950
6762822398,1420,7,1420,0,3,1956,413107
6762823570,2580,8,1290,1290,4,1958,383000
6762824913,2420,7,1620,800,4,1964,350000
6762825032,2530,8,2530,0,4,1994,349900
6762825252,2732,7,2732,0,6,2009,343000
6762825510,1690,8,1690,0,3,1997,337000
6762825607,1900,7,1900,0,4,2007,335000
6762825697,2750,8,2750,0,4,2008,333000
6762825724,2380,7,2380,0,4,2010,332000
6762825805,1320,7,1320,0,3,1970,330000
6762825877,1260,7,1170,90,2,2008,329950
6762825910,980,8,980,0,2,2008,329000
6762826054,1850,8,1850,0,4,1997,325000
6762826055,1020,7,1020,0,2,2008,325000
6762826356,1510,7,1510,0,3,2007,319950
6762826458,1130,7,1130,0,3,1908,315450
6762826505,580,6,580,0,1,2000,315000
6762826719,2310,8,2310,0,4,2010,310000
6762826928,1030,7,1030,0,2,1925,305000
6762827135,1700,7,1700,0,3,1993,300000
6762827297,1852,7,1852,0,3,2014,298900
6762828065,1280,5,1280,0,3,1932,279000
6762828313,1500,6,890,610,3,1945,273000
6762828424,1660,7,1660,0,3,2002,270000
6762828584,1920,7,1920,0,3,2005,266950
6762828593,1120,7,1120,0,3,1957,266000
6762828780,1780,7,1060,720,3,1957,261000
6762828840,2150,8,2150,0,4,2006,260000
6762829249,890,6,890,0,2,1951,250000
6762829250,1860,7,1090,770,4,1977,250000
6762829361,1630,7,1630,0,4,1943,249000
6762829494,1260,7,1260,0,3,1985,245000
6762829652,1350,7,950,400,3,1959,240000
6762829835,1270,6,1270,0,2,1917,235000
6762830070,2160,7,1320,840,4,1978,228950
6762830249,780,6,780,0,2,1939,221900
6762830389,1540,7,1360,180,3,2007,216650
6762830390,1480,7,1300,180,3,2007,216650
6762830950,1180,6,820,360,3,1944,194000
6762831044,860,5,860,0,2,1953,187000
6762831116,1800,7,1800,0,3,1996,180500
6762810267,4280,9,3900,380,4,1947,1900000
6762810834,3440,9,3440,0,4,2014,1290000
6762811568,3830,9,3830,0,4,2014,989990
6762811739,2710,8,1910,800,5,1953,951250
6762811876,2890,9,2890,0,3,2014,930000
6762811950,3670,9,1950,1720,3,1979,920000
6762811981,1560,7,1560,0,3,1952,915000
6762812073,4020,8,2010,2010,8,1968,900000
6762812340,3400,8,2000,1400,4,1980,865000
6762812490,2620,9,2060,560,3,1977,850000
6762812879,2150,8,1850,300,4,1926,810000
6762813232,2610,7,1310,1300,3,1941,780000
6762813233,1660,8,1660,0,5,1929,780000
6762813234,4310,8,2950,1360,6,2008,780000
6762813266,2740,8,1370,1370,4,1937,779000
6762813276,3170,8,3170,0,4,1979,777000
6762813314,1890,7,1390,500,4,1906,775000
6762813711,2040,7,1020,1020,4,1959,749000
6762813963,1940,8,1310,630,3,1915,728000
6762814248,2750,8,1630,1120,4,1966,710000
6762814371,2240,9,1440,800,3,1977,700000
6762814715,2830,9,2830,0,4,1998,680000
6762815651,1180,7,1180,0,3,1926,630500
6762815802,1920,8,1920,0,4,1979,625000
6762815962,2470,7,1600,870,4,1978,618000
6762816108,2130,7,1650,480,4,1919,610000
6762816574,2240,8,2240,0,4,1991,590000
6762817160,1440,7,1440,0,3,1910,567500
6762817301,2040,7,1020,1020,5,1962,561750
6762817441,2230,7,1220,1010,4,1957,556000
6762817646,2160,7,1500,660,5,1950,550000
6762817647,2410,8,2060,350,4,1936,550000
6762818153,2620,9,2620,0,5,2007,535000
6762818283,2160,8,1460,700,3,1960,530000
6762818284,2440,8,1840,600,3,1987,530000
6762818567,1520,7,1520,0,3,1956,522500
6762819143,1760,7,1760,0,2,1964,500000
6762819374,1460,7,1460,0,3,1972,495000
6762819375,2040,7,1020,1020,4,1917,495000
6762819427,1910,7,1060,850,4,1910,493000
6762819656,3110,9,3110,0,4,1995,485000
6762820149,1830,8,1830,0,3,1963,470000
6762820364,780,7,780,0,2,1928,464050
6762820470,1370,8,1370,0,3,2005,460000
6762820535,2260,8,1660,600,4,1978,459000
6762820548,1160,7,860,300,2,1941,458500
6762820849,1360,6,1360,0,3,1910,450000
6762821495,1180,7,1060,120,3,1939,435000
6762822187,1180,8,840,340,2,2008,419000
6762822402,2380,7,1750,630,4,1995,413000
6762822720,1430,7,1130,300,2,1934,403250
6762823020,2650,8,2650,0,4,2014,398651
6762823604,1530,7,1110,420,4,1981,381800
6762823902,1200,6,1200,0,3,1937,375000
6762824089,2490,8,2490,0,3,1995,370000
6762824166,2110,7,1210,900,3,1959,369000
6762824347,2180,7,1090,1090,4,1962,363500
6762824510,2260,8,2260,0,4,2014,359950
6762824673,2344,8,1560,784,5,1976,355000
6762824674,1440,7,1440,0,4,1969,355000
6762825174,710,6,710,0,3,1950,345000
6762825175,1160,7,1160,0,2,1949,345000
6762825253,1230,7,1230,0,2,1961,343000
6762825354,2140,7,1240,900,3,1948,340000
6762826506,770,6,770,0,1,1910,315000
6762826655,1000,7,1000,0,2,1947,311300
6762826720,670,5,670,0,1,1920,310000
6762826721,1120,7,1120,0,1,2011,310000
6762826929,800,7,800,0,2,2006,305000
6762826930,1120,7,1120,0,2,2012,305000
6762827702,2040,7,1030,1010,5,1963,287000
6762827794,1780,8,1780,0,3,1956,285000
6762827795,2434,8,2434,0,4,2007,285000
6762828217,1960,7,1060,900,4,1972,275000
6762828218,1170,7,840,330,3,2007,275000
6762828343,2040,8,1580,460,4,1978,272000
6762828425,2100,8,2100,0,3,1979,270000
6762828781,1584,7,1584,0,3,2012,261000
6762829340,1610,8,1610,0,3,2005,249900
6762829439,1440,8,1130,310,3,1983,246000
6762829584,2170,7,1690,480,3,1980,242050
6762829653,1420,5,1040,380,4,1942,240000
6762829654,1100,7,1100,0,3,1991,240000
6762829744,2240,7,2240,0,5,1990,238000
6762829836,1270,6,1270,0,3,1949,235000
6762830802,910,6,910,0,2,2003,200000
6762830871,1440,5,1440,0,4,1943,199000
6762830953,950,7,950,0,2,1946,193500
6762831401,1530,6,1020,510,3,1992,154000
6762831437,840,6,840,0,2,1925,150000
6762810350,4010,10,4010,0,4,2007,1740000
6762810506,2950,8,1560,1390,2,1942,1550000
6762810584,4200,12,3640,560,4,1996,1460000
6762811226,3590,10,3590,0,4,2012,1100000
6762811277,4200,11,4200,0,4,1990,1080000
6762811401,4320,10,3280,1040,4,2005,1040000
6762812560,1620,7,1620,0,3,1920,842000
6762812729,1240,7,1240,0,2,1915,825000
6762812785,2980,11,2980,0,3,1990,820000
6762812989,2010,8,1010,1000,4,1950,800000
6762813200,1500,7,1500,0,4,1905,782000
6762813235,3720,10,3720,0,4,2007,780000
6762813259,2680,9,2680,0,2,2002,779950
6762813315,3180,8,2530,650,4,1920,775000
6762813473,2870,9,2870,0,5,2014,760369
6762813738,1390,7,1390,0,3,1951,745000
6762813862,2380,7,1820,560,4,1946,735000
6762814716,1800,7,1350,450,3,1970,680000
6762815494,2840,6,2720,120,6,1948,640000
6762816109,2080,7,2080,0,3,2000,610000
6762816326,2310,8,2310,0,4,2005,600000
6762816327,2090,8,1420,670,4,1966,600000
6762816961,2610,8,2610,0,3,2004,575000
6762817081,1100,7,1100,0,2,1941,570000
6762817082,2280,8,2280,0,4,2003,570000
6762818568,2100,7,1300,800,4,1947,522500
6762818580,1290,7,1290,0,3,1950,521450
6762818750,3590,9,3590,0,4,1997,515000
6762819144,1530,8,1530,0,3,1972,500000
6762819145,1120,7,1120,0,2,1923,500000
6762820056,1100,7,1100,0,2,1908,474000
6762820199,1190,8,1190,0,3,2008,469000
6762820234,2500,7,1850,650,5,1979,467000
6762820297,1920,7,1240,680,3,1961,465000
6762820850,3150,8,2370,780,3,1970,450000
6762821009,1570,8,1570,0,3,1991,447450
6762821028,2410,7,1260,1150,4,1958,446800
6762821164,1690,7,1690,0,3,2002,442500
6762821620,2440,9,2440,0,3,1996,431000
6762822011,2000,8,1430,570,3,1978,423500
6762822171,1360,7,1360,0,3,1986,419500
6762822211,1500,7,1500,0,3,1984,418000
6762822662,1900,7,1390,510,3,1978,405000
6762822872,2320,6,1310,1010,4,1921,400000
6762823134,2310,8,2310,0,3,1989,395000
6762823135,1780,7,1780,0,4,1948,395000
6762823291,1040,7,1040,0,3,1961,390000
6762824790,1000,7,1000,0,3,1985,352500
6762824914,2500,8,2500,0,4,2008,350000
6762825176,2040,8,2040,0,4,2004,345000
6762826168,1420,7,1420,0,3,1966,324450
6762826288,1970,8,1970,0,4,2005,320000
6762826507,1770,5,1770,0,3,1948,315000
6762826722,3140,8,1820,1320,4,1960,310000
6762826789,1275,6,1275,0,4,1991,309600
6762826799,1990,7,1990,0,3,2005,309000
6762827423,2610,6,1690,920,4,1940,294950
6762827968,1710,8,1030,680,4,1976,280000
6762828652,1380,7,1140,240,3,1987,265000
6762828653,1340,7,1140,200,3,1981,265000
6762828966,2930,9,2930,0,5,2002,257000
6762829417,1820,8,1820,0,3,1987,247000
6762829495,1070,6,910,160,2,1932,245000
6762830159,800,6,800,0,2,1944,225000
6762830226,1360,7,1360,0,3,1984,223000
6762830402,1260,6,1260,0,3,1998,216000
6762830444,1280,6,1280,0,3,1983,215000
6762830445,1760,7,1100,660,3,1947,215000
6762830568,1700,7,1700,0,3,1967,210000
6762830752,1120,6,1120,0,3,1943,202500
6762830993,1370,7,1370,0,2,1987,190000
6762830994,1260,6,1260,0,3,1943,190000
6762831199,960,6,770,190,2,1951,175000
6762831565,730,6,730,0,2,1928,114000
6762810293,3680,9,2630,1050,5,1925,1850000
6762811465,2240,9,2240,0,3,1945,1010000
6762814569,2980,10,2490,490,4,2006,690000
6762818285,2500,7,1250,1250,5,1968,530000
6762823185,3620,8,2790,830,5,2004,394000
6762829496,1450,7,1450,0,3,1972,245000
6762817736,2930,8,2440,490,3,1995,549950
6762817910,2730,8,1530,1200,5,1989,542500
6762823667,1470,8,1310,160,3,2003,380000
6762825472,2130,8,1370,760,3,1999,338500
6762810026,8010,12,5990,2020,5,1999,5110000
6762810049,7710,12,6090,1620,8,1904,3300000
6762810853,3560,8,2060,1500,4,1977,1280000
6762811199,3090,9,2060,1030,5,2000,1110000
6762811495,2120,8,2120,0,5,1939,1000000
6762811726,3830,9,3830,0,5,2014,955990
6762812023,3420,8,2430,990,3,1939,908800
6762812074,1190,7,1190,0,4,1945,900000
6762812115,4370,10,4370,0,4,1984,897500
6762812116,2820,9,2820,0,4,2014,897000
6762812491,1540,8,1540,0,3,1900,850000
6762812847,3430,10,3430,0,4,1998,813000
6762813236,2430,7,1830,600,3,1924,780000
6762813271,2260,9,1690,570,3,1974,778000
6762813433,1220,7,1220,0,3,1954,765000
6762813434,4040,10,4040,0,4,2000,765000
6762814041,3010,9,3010,0,4,2004,724950
6762814372,1300,8,1300,0,2,1959,700000
6762814908,1800,7,1240,560,3,1985,670000
6762815144,2380,8,1680,700,4,1957,655500
6762815495,3420,9,3420,0,4,2002,640000
6762815678,1610,7,1610,0,4,1946,630000
6762816110,2520,9,2520,0,5,1977,610000
6762816446,2620,7,2620,0,3,2002,597500
6762817012,1430,9,1430,0,4,1930,574500
6762817083,1790,8,1490,300,2,1912,570000
6762817293,2170,8,1540,630,4,1974,562000
6762817475,2600,8,1620,980,4,1978,555000
6762817893,2550,8,2550,0,4,1998,543500
6762818039,2620,7,2620,0,7,1961,539000
6762818286,1880,8,1880,0,3,1987,530000
6762818384,2900,8,2900,0,4,2013,527000
6762818841,1250,7,1250,0,2,1923,511000
6762819146,2080,8,1390,690,4,1964,500000
6762819147,1160,6,820,340,4,1913,500000
6762820150,2100,8,2100,0,3,1999,470000
6762820151,1280,8,1040,240,3,2000,470000
6762820851,1350,7,1350,0,3,1954,450000
6762821133,2000,6,2000,0,3,1946,443950
6762821599,2410,7,1600,810,4,1978,432000
6762821726,1430,7,1430,0,3,1962,429950
6762821906,3680,9,3680,0,4,1981,425000
6762822098,1050,6,800,250,3,1950,420000
6762822099,1940,8,1940,0,4,1997,420000
6762822321,1500,7,1300,200,3,1926,415000
6762822379,2200,7,1100,1100,4,1918,414950
6762822437,1040,7,1040,0,3,1958,411100
6762822497,2220,7,1260,960,4,1983,410000
6762822663,960,7,960,0,3,1943,405000
6762822955,1140,8,1010,130,2,1999,399950
6762823186,1680,7,1680,0,3,2008,394000
6762823292,2250,8,2250,0,3,1995,390000
6762823499,2360,7,1180,1180,4,1955,385000
6762823782,2610,7,1390,1220,3,1981,378000
6762823903,1140,8,1140,0,3,2007,375000
6762823967,1240,8,1000,240,2,2008,374950
6762824367,2330,7,1270,1060,5,1961,362500
6762824526,2170,8,2170,0,5,2014,359800
6762824675,1200,7,1200,0,3,1970,355000
6762824676,1430,7,1430,0,3,2010,355000
6762824915,1630,7,1630,0,3,1986,350000
6762824916,2130,7,1090,1040,3,1956,350000
6762825003,2220,8,2220,0,4,2014,349990
6762825355,2441,8,2441,0,4,2007,340000
6762825511,2470,8,2470,0,4,2005,337000
6762825652,1700,8,1700,0,4,1961,334950
6762825707,1710,7,1710,0,2,1987,332544
6762826233,1290,7,1290,0,3,1961,321000
6762826289,2223,8,2223,0,4,2010,320000
6762826590,1350,8,1100,250,3,1953,314000
6762826723,1330,6,1330,0,3,1903,310000
6762826844,1310,6,1110,200,5,1929,307000
6762827136,3080,7,1580,1500,6,1985,300000
6762827386,1830,7,1100,730,3,1948,295000
6762828128,1610,7,1110,500,3,1968,277000
6762828560,1600,7,1600,0,3,1963,267500
6762828841,750,6,750,0,2,1916,260000
6762829251,1480,7,1480,0,3,1980,250000
6762829252,1510,7,1510,0,4,1920,250000
6762829655,870,7,870,0,2,1960,240000
6762829987,870,6,570,300,2,1942,230000
6762830803,960,6,960,0,3,1953,200000
6762830965,470,5,470,0,1,1924,192500
6762830995,1200,6,1200,0,3,1961,190000
6762810301,4500,11,2630,1870,4,2009,1830000
6762810592,4170,10,4170,0,5,2008,1450000
6762810742,2130,9,2130,0,4,1955,1340000
6762810987,2470,9,1570,900,4,1960,1210000
6762811020,3180,11,3180,0,4,1986,1200000
6762811081,4220,11,4220,0,5,2004,1170000
6762811166,4300,11,3580,720,4,1987,1130000
6762811516,2810,9,1900,910,5,1910,999000
6762811847,4110,11,4110,0,4,1995,935000
6762812730,3070,9,3070,0,5,2011,825000
6762813032,2760,8,2760,0,4,1993,799500
6762813056,2849,10,2849,0,3,2001,798000
6762813409,2170,8,1710,460,4,1997,767250
6762813842,1980,8,1980,0,3,1993,736000
6762814478,2540,7,1630,910,4,1925,696500
6762814594,2080,8,1700,380,3,1940,689000
6762814717,3310,9,3310,0,4,1998,680000
6762814824,2320,8,1380,940,3,1978,675000
6762814878,3470,9,3470,0,4,2005,672500
6762815283,1910,7,1010,900,5,1908,650000
6762815455,2600,8,2600,0,4,2004,641000
6762816328,2360,8,1780,580,4,1973,600000
6762816575,2210,8,1460,750,3,1951,590000
6762817216,1130,8,1130,0,2,2006,565000
6762817920,1930,8,1930,0,2,2003,542000
6762818375,1380,8,1380,0,3,2008,527500
6762818751,3290,10,3290,0,3,1988,515000
6762819004,2519,8,2519,0,3,1973,505000
6762819148,1070,7,950,120,3,1930,500000
6762819279,2680,8,2680,0,4,2004,499000
6762819376,1770,8,1770,0,3,1968,495000
6762819377,1160,8,1000,160,2,2006,495000
6762819502,950,6,810,140,2,1925,490000
6762819572,1465,7,1050,415,2,2006,489000
6762820075,1700,8,1700,0,2,2005,472500
6762820471,2200,8,1500,700,4,1979,460000
6762820536,1780,8,1780,0,3,1995,459000
6762820639,1700,7,850,850,3,1955,455000
6762820966,2580,8,2580,0,4,1998,449500
6762821093,1710,8,1360,350,3,2004,445000
6762821181,990,6,990,0,2,1917,442000
6762821267,2030,8,1550,480,4,1979,440000
6762822212,1530,7,1530,0,3,1959,418000
6762822498,2200,7,2200,0,4,1990,410000
6762822499,1230,7,1090,140,3,1924,410000
6762823136,1450,8,1160,290,3,2007,395000
6762823422,1170,8,1170,0,2,2001,387000
6762823904,2990,8,2990,0,4,2003,375000
6762824039,2150,8,2150,0,3,1991,371000
6762824090,1530,7,1530,0,3,1978,370000
6762824218,1400,8,1400,0,3,2006,367000
6762824235,1320,6,660,660,3,1918,366000
6762825109,1570,8,1290,280,3,2006,346500
6762825416,2180,7,2180,0,4,2000,339995
6762826290,1660,6,830,830,4,1948,320000
6762826508,1680,7,930,750,3,1952,315000
6762826572,890,6,890,0,2,1943,314963
6762827055,2150,8,2150,0,4,1990,300499
6762827564,770,7,770,0,2,1943,290000
6762827624,1090,6,1090,0,3,1947,289950
6762827703,1150,7,1150,0,3,1971,287000
6762827969,1260,6,1260,0,3,1947,280000
6762828219,1410,7,1410,0,3,1953,275000
6762828561,2080,7,1550,530,3,2003,267500
6762828587,1740,7,1210,530,3,1998,266500
6762828654,1820,7,1820,0,3,1966,265000
6762828742,1660,7,1660,0,3,1977,263000
6762829001,1770,7,1770,0,3,2009,255500
6762829253,2600,8,1410,1190,4,1959,250000
6762829362,1280,6,1280,0,4,1959,249000
6762829415,1910,7,1910,0,3,1922,247200
6762829656,1290,7,1020,270,3,1957,240000
6762829877,1990,7,1140,850,3,1946,234550
6762830044,1100,7,1100,0,3,1981,229900
6762830160,1800,8,1800,0,4,1969,225000
6762830161,1460,7,1460,0,3,1968,225000
6762830162,1370,6,1370,0,3,1945,225000
6762830241,1240,8,1070,170,3,1967,222000
6762830398,1120,6,1120,0,2,1948,216180
6762830485,1580,7,1580,0,3,1990,213550
6762830661,1390,7,1390,0,3,1987,206600
6762830804,1210,7,1210,0,3,1958,200000
6762830879,1040,7,1040,0,3,1962,198400
6762830922,1140,7,1140,0,3,1969,195000
6762831045,1280,6,1280,0,3,1985,187000
6762831108,1130,6,1130,0,4,1929,182200
6762831132,1150,6,1150,0,2,1958,180000
6762831517,840,7,840,0,2,1951,130000
6762831553,700,6,480,220,2,1951,119900
6762831556,670,6,670,0,1,1978,118000
6762810543,3070,10,2180,890,4,1962,1500000
6762810651,4230,10,3450,780,5,2008,1400000
6762810687,1850,8,1850,0,3,1953,1380000
6762810904,2960,9,2160,800,5,1959,1250000
6762811096,2960,8,1480,1480,4,1949,1160000
6762811324,3850,11,2430,1420,4,1995,1060000
6762811659,3400,10,3400,0,3,1983,970000
6762811660,3400,9,2550,850,5,2008,970000
6762812008,3170,10,3170,0,4,1989,910000
6762812492,3450,8,2450,1000,4,1994,850000
6762812542,3160,8,2100,1060,4,1933,845000
6762812580,2500,9,1560,940,5,1966,840000
6762812671,2760,10,2000,760,3,1991,830000
6762812731,2040,9,2040,0,4,1903,825000
6762812732,3620,9,3620,0,4,2003,825000
6762813316,2780,9,2780,0,3,2000,775000
6762813558,3020,9,3020,0,3,1989,755000
6762813921,3370,10,2250,1120,4,2001,730000
6762814373,2420,7,2420,0,4,1900,700000
6762814642,2320,8,2320,0,3,1993,685000
6762814773,2340,8,1810,530,5,1918,677500
6762815284,1930,8,1930,0,4,1914,650000
6762815803,2220,9,2220,0,4,1989,625000
6762816111,1180,8,1180,0,3,1907,610000
6762816270,1740,9,1180,560,3,2012,601000
6762816962,1800,7,1600,200,3,1925,575000
6762817048,2280,8,1380,900,5,1949,571000
6762817084,1490,7,1490,0,4,1915,570000
6762817085,3420,9,3420,0,4,1989,570000
6762817355,2520,8,1440,1080,4,1977,560000
6762817648,1550,8,1390,160,3,2004,550000
6762818475,1710,8,1280,430,3,1981,525000
6762819503,1420,7,920,500,2,1941,490000
6762819754,2580,9,2580,0,3,1990,481000
6762820546,1530,7,1130,400,2,1946,458950
6762820562,2150,8,1450,700,3,1977,458000
6762820978,2230,8,2230,0,4,1968,449000
6762820979,1980,8,1980,0,4,1998,449000
6762821182,860,7,860,0,2,1948,442000
6762821268,1760,8,1290,470,3,1976,440000
6762821348,2060,7,2060,0,4,1975,439000
6762822100,960,7,960,0,2,1955,420000
6762822572,2670,8,2670,0,3,2014,408000
6762822873,1470,7,1470,0,3,1987,400000
6762823032,1890,7,1890,0,3,1950,398000
6762823137,1400,7,710,690,2,1916,395000
6762823571,1410,7,1410,0,3,1967,383000
6762823668,1610,7,1610,0,3,2002,380000
6762823722,1270,7,1270,0,3,1977,379950
6762824450,2160,9,2160,0,4,1992,360000
6762824451,2050,8,2050,0,4,1992,360000
6762824452,1660,7,1660,0,3,1963,360000
6762824806,760,4,760,0,2,1931,352000
6762825356,2550,8,2550,0,4,2001,340000
6762825608,2588,8,2588,0,3,2008,335000
6762826291,1820,7,1000,820,4,1997,320000
6762826427,2020,7,1180,840,3,1926,317000
6762826724,3130,8,2190,940,3,1987,310000
6762826725,1180,7,1180,0,3,1956,310000
6762827002,1640,8,1640,0,3,1952,303100
6762827035,3320,7,1750,1570,4,1963,302000
6762827239,2090,8,2090,0,3,1989,299500
6762827387,1330,7,900,430,3,1974,295000
6762827424,1160,7,1160,0,3,1968,294950
6762827425,1740,7,1160,580,4,1957,294950
6762827970,1358,7,1358,0,3,2007,280000
6762828426,1560,7,1560,0,3,1967,270000
6762828655,1720,7,1720,0,3,1993,265000
6762828656,1290,6,1290,0,3,1954,265000
6762828842,1030,6,1030,0,3,1947,260000
6762829594,1640,7,1640,0,3,1963,242000
6762829608,1070,7,1070,0,2,1995,241000
6762829718,1070,7,1070,0,3,1952,239300
6762829837,1500,6,1500,0,2,1947,235000
6762830035,2150,7,1240,910,4,1976,229950
6762830256,1320,7,880,440,3,2005,221000
6762830446,1240,7,1240,0,3,1966,215000
6762830703,770,4,770,0,3,1942,205000
6762830805,780,4,780,0,2,1945,200000
6762831321,940,7,940,0,3,1954,163500
6762810498,3910,9,2890,1020,5,1960,1560000
6762811065,4150,11,4150,0,4,2003,1180000
6762811097,2490,9,1580,910,3,1961,1160000
6762811710,3430,10,3430,0,4,1979,960000
6762812099,3720,10,3720,0,4,1988,899000
6762812112,2650,9,1770,880,3,1977,898000
6762812786,3850,10,3850,0,3,2000,820000
6762812990,2540,10,2540,0,4,1998,800000
6762813120,3030,9,2130,900,5,1976,790000
6762813147,2910,8,1910,1000,5,1972,788000
6762813237,3690,10,3690,0,4,1996,780000
6762813317,2690,8,2690,0,3,1948,775000
6762813754,2020,8,2020,0,3,1981,744000
6762814825,2770,10,2770,0,3,1982,675000
6762815017,1870,8,1250,620,4,1974,664000
6762815285,2770,7,2770,0,4,2001,650000
6762815876,1340,7,1340,0,3,1927,621000
6762815911,990,7,990,0,2,1909,620000
6762817011,1630,8,1630,0,3,1932,574800
6762817086,1570,8,1260,310,3,2007,570000
6762817356,1360,6,1360,0,4,1900,560000
6762818040,1740,9,1740,0,3,1974,539000
6762818584,1840,6,1840,0,3,1908,521000
6762818614,2030,8,2030,0,3,1984,520000
6762818713,2180,8,2180,0,3,1994,515700
6762818752,1440,8,1440,0,3,1987,515000
6762818876,2990,8,2990,0,4,1974,510000
6762819321,1450,8,1450,0,3,2000,497000
6762819657,1650,8,1650,0,3,2000,485000
6762819904,2250,8,2250,0,4,1998,476500
6762820235,1320,8,1320,0,2,1947,467000
6762821018,850,6,850,0,2,1924,447000
6762821429,1240,7,1240,0,2,1925,436000
6762821496,870,7,870,0,2,1950,435000
6762822019,1820,7,1040,780,3,1952,423000
6762822026,1560,7,1560,0,3,1962,422500
6762822409,1680,7,1680,0,3,2007,412500
6762822449,1150,7,1150,0,3,1954,410500
6762822739,1270,7,1270,0,4,1903,402500
6762822956,2450,7,1980,470,3,1989,399950
6762823033,3004,9,3004,0,5,2006,398000
6762823500,1620,7,1620,0,4,1924,385000
6762823501,2120,8,2120,0,4,1978,385000
6762823502,1330,7,1330,0,3,1924,385000
6762823550,2430,8,2430,0,3,1986,384200
6762823760,1500,7,1000,500,3,1972,379000
6762823768,1820,7,1300,520,4,1956,378950
6762823807,2643,8,2643,0,4,2012,376950
6762824018,1330,8,1060,270,3,2014,372000
6762824917,830,7,830,0,2,1942,350000
6762825609,1980,7,1980,0,4,2004,335000
6762825963,1620,7,1620,0,4,1905,327000
6762826509,1660,7,1660,0,3,1951,315000
6762826510,1940,7,1100,840,1,1979,315000
6762826726,2610,7,1670,940,3,1918,310000
6762826727,1590,7,1590,0,3,2001,310000
6762827137,1800,7,1800,0,3,2001,300000
6762827138,1730,8,1730,0,3,1985,300000
6762827625,2070,7,2070,0,3,2003,289950
6762827734,1680,8,1680,0,3,1987,286000
6762827914,1850,8,1850,0,3,1996,280017
6762829389,790,6,790,0,1,1918,248000
6762829657,1240,6,1240,0,3,1987,240000
6762829892,1710,7,1030,680,4,1975,234000
6762829988,1160,7,790,370,3,2007,230000
6762830323,940,7,940,0,2,1955,219950
6762830569,1160,7,1160,0,3,1970,210000
6762830655,1690,7,1690,0,4,1967,207000
6762830724,970,6,970,0,2,1904,204995
6762830772,1660,6,1660,0,5,1915,201000
6762831164,1200,7,1200,0,3,1961,178500
6762831278,1720,8,1720,0,3,1978,169000
6762831292,1120,7,1120,0,1,1988,166000
6762831309,1280,7,1280,0,3,1973,165000
6762831317,1530,7,1530,0,4,1977,164000
6762810688,3500,10,2460,1040,4,1996,1380000
6762811167,3690,9,2070,1620,5,1967,1130000
6762811810,3570,10,3570,0,4,2006,942500
6762811840,5100,10,3640,1460,7,2001,936000
6762812215,2340,8,2340,0,4,1953,880000
6762813318,2010,7,2010,0,3,1951,775000
6762813319,3500,9,3500,0,4,2004,775000
6762814014,2110,7,1990,120,3,1927,725000
6762814195,2830,9,1730,1100,3,1954,713414
6762814826,3130,8,1620,1510,4,1978,675000
6762814827,2780,7,1710,1070,4,1919,675000
6762815286,2620,8,2620,0,4,1984,650000
6762815287,1494,8,1494,0,3,2011,650000
6762815408,2780,8,2780,0,4,2001,645000
6762815496,2020,8,1120,900,5,1956,640000
6762816576,3700,8,1920,1780,4,1973,590000
6762817161,3090,9,3090,0,3,1990,567500
6762817217,4320,8,2160,2160,5,1967,565000
6762817218,1870,8,1380,490,3,2007,565000
6762817983,2850,9,2850,0,4,1991,540000
6762818061,1850,7,1060,790,2,1929,538000
6762818476,1550,7,1550,0,3,1918,525000
6762818477,1560,6,780,780,3,1944,525000
6762818935,2600,9,1840,760,4,1983,509000
6762819054,2140,7,1550,590,4,1977,502000
6762819986,1380,8,1140,240,3,2007,475000
6762820086,4350,8,2870,1480,4,1999,472000
6762820298,1020,7,1020,0,1,1927,465000
6762820852,2450,8,1410,1040,4,1978,450000
6762821094,1260,8,1260,0,3,2007,445000
6762821202,1600,7,1600,0,3,2002,440500
6762822101,1100,8,1100,0,2,2008,420000
6762822614,2830,8,2830,0,5,1918,405600
6762822664,1430,7,1430,0,3,1960,405000
6762823067,1340,7,1340,0,3,1953,397000
6762823503,2080,7,2080,0,4,1948,385000
6762823556,990,8,880,110,3,2009,384000
6762824010,1550,7,1210,340,3,1988,372500
6762824453,2030,7,1210,820,3,1979,360000
6762824454,840,6,840,0,2,1928,360000
6762824677,1210,6,1210,0,3,1959,355000
6762825806,1820,7,1820,0,4,2001,330000
6762826292,1380,7,1380,0,2,1918,320000
6762826511,780,6,780,0,2,1935,315000
6762827719,1720,7,1440,280,3,1974,286900
6762828029,1510,7,1210,300,3,1965,279950
6762828476,1960,8,1960,0,4,2002,269950
6762828967,1800,7,1200,600,3,1961,257000
6762828996,1500,7,1500,0,4,1964,255950
6762829254,1640,7,1640,0,3,1918,250000
6762829726,1370,7,1370,0,4,1955,239000
6762829727,1330,7,900,430,3,1971,239000
6762829770,1270,7,1270,0,3,1960,237000
6762829989,680,6,680,0,3,1903,230000
6762829990,1420,5,710,710,3,1931,230000
6762830908,1230,6,1230,0,4,1954,195500
6762830956,1180,7,1180,0,3,1977,193000
6762831349,1010,6,1010,0,3,1950,160000
6762819504,990,7,990,0,2,1941,490000
6762820853,1740,7,1740,0,3,1949,450000
6762823293,1610,7,1190,420,3,1969,390000
6762826641,1750,7,1750,0,3,2013,312000
6762831366,1580,6,790,790,4,1944,159075
6762812880,3290,9,3290,0,5,2012,810000
6762813559,2420,9,1620,800,3,1957,755000
6762816508,2557,7,2557,0,4,1948,594950
6762823294,860,7,860,0,2,1909,390000
6762810186,4250,10,3350,900,4,1980,2200000
6762810375,2500,8,2500,0,5,1942,1700000
6762811227,2420,8,1420,1000,3,1948,1100000
6762811361,2630,9,1810,820,4,1909,1050000
6762811362,4240,9,4240,0,5,2014,1050000
6762811532,4270,9,4270,0,4,2008,997950
6762811848,4230,10,4230,0,5,1999,935000
6762811913,4420,9,3420,1000,4,1962,925000
6762812051,3030,9,2360,670,4,1973,901000
6762812581,3040,11,3040,0,4,2003,840000
6762812672,2710,9,1910,800,5,1959,830000
6762814090,1760,7,1760,0,4,1906,720000
6762814169,1670,7,1670,0,3,1925,715000
6762814643,1550,6,1370,180,4,1930,685000
6762814947,2040,7,1020,1020,3,1949,667500
6762815288,1710,7,1560,150,3,1928,650000
6762815679,1930,8,1670,260,4,1941,630000
6762815865,1720,7,1420,300,3,1959,622200
6762815912,1900,7,1900,0,4,1967,620000
6762816112,1660,8,1660,0,4,1965,610000
6762816204,1550,8,1550,0,2,1927,605000
6762816329,2090,8,2090,0,4,1987,600000
6762816330,2710,8,1650,1060,3,2006,600000
6762816436,3040,9,3040,0,3,2004,598555
6762817476,1980,7,1440,540,3,1929,555000
6762817803,2678,9,2678,0,3,1998,546200
6762817984,3000,8,3000,0,4,2013,540000
6762818154,1920,7,1920,0,4,1920,535000
6762818287,1660,7,960,700,3,1941,530000
6762818288,1365,7,1315,50,3,2003,530000
6762818478,1350,7,900,450,3,1950,525000
6762818815,2090,7,1480,610,4,1951,513000
6762818834,1700,6,850,850,2,1915,511718
6762819556,2540,8,2540,0,3,2011,489950
6762819605,4750,8,4750,0,6,1947,487000
6762819658,1210,7,1210,0,4,1936,485000
6762819722,1220,7,1220,0,4,1927,483000
6762820087,2030,7,1110,920,5,1963,472000
6762820299,730,6,730,0,2,1918,465000
6762820472,1660,8,1660,0,3,1978,460000
6762820854,2480,7,2480,0,3,2002,450000
6762821019,2660,8,2660,0,4,1997,447000
6762821269,1100,7,750,350,2,2006,440000
6762821497,2530,9,2530,0,3,1989,435000
6762821678,2452,7,2452,0,4,1936,430000
6762822102,1510,7,1510,0,4,1906,420000
6762822322,2010,8,2010,0,3,1986,415000
6762822874,1330,7,1330,0,3,1956,400000
6762823295,2330,8,2330,0,4,1968,390000
6762823423,1340,7,1340,0,3,1972,387000
6762824150,760,5,760,0,1,1936,369900
6762824386,840,6,840,0,2,1909,361500
6762824455,1510,7,1060,450,3,1947,360000
6762824456,2620,7,1550,1070,4,1964,360000
6762824678,1420,7,860,560,3,1923,355000
6762824918,2180,8,2180,0,3,1992,350000
6762825426,2140,8,1290,850,3,1979,339950
6762825665,1990,8,1990,0,3,1989,334500
6762825683,1320,7,1320,0,3,1977,333500
6762825731,2050,7,2050,0,4,1998,331500
6762825737,1290,7,1290,0,3,2008,331000
6762825807,2500,8,2500,0,3,1994,330000
6762825990,2130,7,1330,800,4,1991,325250
6762826204,1940,7,1940,0,4,2000,322500
6762826225,2620,8,2620,0,4,2003,321500
6762826512,1460,8,1460,0,3,1975,315000
6762826513,1340,7,880,460,3,1981,315000
6762826514,1170,6,720,450,3,1943,315000
6762826515,1880,8,1880,0,4,1981,315000
6762826591,720,6,720,0,2,1941,314000
6762826833,1646,7,1646,0,3,1994,307500
6762826854,1390,7,1390,0,2,1949,306500
6762827196,1570,7,1570,0,2,1953,299990
6762827273,1190,7,1190,0,3,1959,299000
6762827274,2350,9,2350,0,4,1998,299000
6762827656,1010,6,890,120,2,1924,289000
6762827657,1160,7,1160,0,2,1982,289000
6762827687,2250,8,2250,0,4,1985,287500
6762827907,2440,7,1220,1220,3,1962,280500
6762828030,1340,7,1340,0,3,1989,279950
6762828096,2710,7,2060,650,3,1965,278000
6762828220,1590,7,1060,530,3,1997,275000
6762828221,1230,7,1230,0,3,1913,275000
6762828275,3030,9,3030,0,3,1987,274975
6762828543,1840,8,1840,0,4,1988,268000
6762828843,2110,8,2110,0,4,1977,260000
6762829440,1990,7,1990,0,3,1949,246000
6762830367,1620,7,1620,0,4,1962,218000
6762830509,1690,7,1210,480,3,1976,212000
6762830570,2140,7,1470,670,3,1978,210000
6762831106,910,7,910,0,3,1971,182500
6762831200,1910,8,1910,0,3,1963,175000
6762831255,1310,7,1310,0,3,1956,170000
6762831395,970,7,970,0,3,1966,155000
6762831499,1220,6,1220,0,2,1914,135000
6762831551,1260,6,1260,0,3,1954,120000
6762810477,3620,8,3220,400,3,2007,1580000
6762810544,3530,10,2370,1160,3,2008,1500000
6762810627,4020,9,3120,900,5,2010,1420000
6762810652,3520,10,3520,0,4,1981,1400000
6762810905,2780,10,2780,0,3,1974,1250000
6762810955,3120,9,2590,530,4,1974,1230000
6762811257,2780,9,2780,0,4,2004,1090000
6762811466,2940,8,1940,1000,4,1910,1010000
6762811807,2370,7,2370,0,3,1980,943500
6762811819,2800,9,1650,1150,4,1965,940000
6762811849,3150,10,1800,1350,5,1975,935000
6762812235,3030,9,2080,950,3,1929,879000
6762812341,2790,9,2790,0,4,1999,865000
6762812516,3300,9,3300,0,4,2014,849990
6762812543,2880,10,2880,0,4,1989,845000
6762812582,2100,8,1750,350,4,1929,840000
6762812673,2920,8,2140,780,5,1960,830000
6762812733,3760,9,3230,530,3,2002,825000
6762812814,2310,8,1790,520,3,1926,817000
6762812828,1400,7,1400,0,4,1986,815000
6762813395,2190,7,1260,930,3,1952,769950
6762813435,3190,9,3190,0,3,1982,765000
6762813502,4040,9,4040,0,3,2004,760000
6762813535,1960,8,1960,0,3,1900,759000
6762813640,3010,10,3010,0,3,2001,750000
6762813701,2440,9,2440,0,4,1987,749500
6762813786,2960,9,2960,0,3,1978,740000
6762814249,2880,10,2880,0,4,1996,710000
6762814504,2390,8,1390,1000,4,1957,695000
6762814644,1570,7,1570,0,3,1922,685000
6762814933,2550,9,2550,0,4,1989,669888
6762815680,3640,8,2740,900,4,2010,630000
6762815963,3200,9,3200,0,3,1977,618000
6762816420,2480,7,2480,0,4,2004,599000
6762816963,2670,8,2320,350,7,1948,575000
6762817649,1690,7,1400,290,4,1945,550000
6762817650,2090,10,2090,0,3,1988,550000
6762817789,2550,9,2550,0,3,1990,547500
6762817849,3550,10,3550,0,3,1977,545000
6762818213,1330,7,1210,120,3,1909,532500
6762818387,1860,8,1860,0,3,1986,526500
6762818615,2160,9,2160,0,3,1999,520000
6762818616,1840,8,1040,800,2,1928,520000
6762818753,1510,8,1060,450,3,2007,515000
6762819443,1690,8,1420,270,3,2005,492000
6762819505,1670,7,1670,0,2,1912,490000
6762819703,1000,7,1000,0,2,1916,484950
6762819723,1400,7,820,580,2,1927,483000
6762819798,3230,9,2520,710,4,2001,480000
6762819912,1630,7,1630,0,3,2004,476000
6762820066,1280,7,1280,0,3,1954,473000
6762820473,2230,7,1410,820,4,1978,460000
6762820855,1540,7,850,690,4,1929,450000
6762820856,1340,7,1340,0,2,1951,450000
6762821095,930,6,930,0,2,1918,445000
6762821349,2610,7,1710,900,5,1988,439000
6762821423,2320,7,2320,0,3,1952,436300
6762821498,1380,7,1380,0,3,2009,435000
6762821679,1470,8,1470,0,3,2005,430000
6762821756,2720,7,1360,1360,5,1970,429000
6762821791,3160,9,3160,0,4,1999,427500
6762822005,1330,8,1330,0,3,1988,424000
6762822103,2390,7,1290,1100,3,1959,420000
6762822323,2150,8,2150,0,4,1987,415000
6762822875,1690,7,1690,0,3,1942,400000
6762822876,960,7,960,0,2,1946,400000
6762823000,2620,8,1420,1200,5,1965,399000
6762823052,1480,7,1480,0,3,1938,397500
6762823057,1030,6,1030,0,2,1924,397380
6762823236,1440,8,1440,0,3,2002,391265
6762823296,1510,7,1510,0,3,1984,390000
6762823383,2420,10,2420,0,4,1998,389000
6762824019,1710,7,1710,0,3,1981,372000
6762824091,1620,7,1620,0,3,1953,370000
6762824142,2050,7,2050,0,4,2005,369950
6762824679,2020,7,1010,1010,2,1948,355000
6762824751,800,6,800,0,2,1942,353500
6762824781,2080,7,1330,750,4,1960,352800
6762824919,1900,8,1220,680,3,1963,350000
6762824920,2390,8,2390,0,4,1987,350000
6762825050,1800,8,1800,0,4,1995,349000
6762825357,1280,6,640,640,2,1919,340000
6762825358,1420,7,830,590,3,1942,340000
6762825496,2070,7,2070,0,5,1999,337500
6762825808,1620,7,1280,340,3,1950,330000
6762825925,2290,9,2290,0,4,1990,328500
6762826176,1940,8,1940,0,3,1990,324000
6762826214,1400,6,1400,0,3,1977,322000
6762826293,1210,7,1210,0,2,1952,320000
6762826516,1290,7,1290,0,2,1984,315000
6762826610,1180,6,1180,0,2,1954,313000
6762826642,1460,7,1260,200,2,1925,312000
6762826791,1250,7,1250,0,3,1968,309500
6762826818,1080,7,1080,0,2,1942,308000
6762827207,1460,7,1460,0,2,1983,299950
6762827472,750,6,750,0,2,1942,292500
6762827565,1590,7,1090,500,3,1980,290000
6762827566,1460,7,1460,0,3,1972,290000
6762827796,2770,8,2770,0,4,1940,285000
6762828113,1820,7,1820,0,3,1964,277500
6762828222,1820,7,1450,370,3,1987,275000
6762828283,1936,7,1936,0,3,2014,274900
6762828427,1510,7,1510,0,3,1995,270000
6762828915,1590,7,1590,0,3,1952,259000
6762829046,1650,7,1100,550,4,1977,255000
6762829412,1140,7,1040,100,2,2009,247300
6762829441,1720,7,1020,700,4,1963,246000
6762829497,1690,7,1360,330,3,1979,245000
6762829658,1500,7,1500,0,3,1992,240000
6762829838,870,6,740,130,2,1954,235000
6762829991,1050,7,1050,0,4,1969,230000
6762830106,1730,6,1730,0,3,1944,226450
6762830382,970,6,970,0,2,1951,217000
6762830606,1100,6,1100,0,3,1968,209950
6762830670,1050,5,1050,0,3,1906,206000
6762830751,1060,6,1060,0,2,1969,202950
6762831364,1000,5,760,240,2,1915,159995
6762810170,4440,10,3140,1300,4,1922,2250000
6762810376,3320,10,3320,0,4,2014,1700000
6762810618,3350,10,2260,1090,5,2014,1430000
6762810689,3330,9,2470,860,5,2014,1380000
6762811082,2810,9,2810,0,5,1907,1170000
6762811325,2990,10,2990,0,3,1974,1060000
6762811402,4180,9,4180,0,5,2014,1040000
6762811611,3730,7,2160,1570,5,1927,979700
6762811769,4100,9,4100,0,5,2011,950000
6762811932,2620,8,1620,1000,4,1941,922000
6762812216,1530,7,1530,0,2,1923,880000
6762812342,2710,10,2710,0,4,1990,865000
6762812829,1820,8,1820,0,4,1921,815000
6762812881,3550,9,2550,1000,5,1998,810000
6762813066,4360,10,3360,1000,4,1993,795127
6762813378,2370,8,1340,1030,5,1926,770000
6762813787,2200,9,1530,670,3,2002,740000
6762813830,2830,9,2170,660,4,2000,738000
6762814505,2660,9,2660,0,4,2002,695000
6762814718,2140,7,2020,120,5,1913,680000
6762815100,1610,9,1080,530,3,2014,659950
6762815195,2680,9,1880,800,3,1950,653000
6762815289,1660,7,1240,420,3,1942,650000
6762815290,3610,7,3010,600,10,1958,650000
6762815409,2550,7,1760,790,4,1926,645000
6762815681,3220,8,3220,0,4,1978,630000
6762815804,1800,9,900,900,3,1927,625000
6762816113,2200,8,1220,980,4,1958,610000
6762816149,1760,8,1640,120,3,2006,608000
6762816331,1350,7,1350,0,3,1997,600000
6762816483,1280,7,1280,0,2,1953,595000
6762816577,2230,7,1330,900,4,1918,590000
6762816642,2310,8,2310,0,3,1942,588000
6762817024,2330,8,1380,950,5,1955,572500
6762817153,2320,9,1790,530,3,1979,568000
6762817549,1280,8,1280,0,3,2009,552000
6762817651,1900,9,1450,450,1,1977,550000
6762817769,2250,8,2250,0,3,1985,549000
6762818155,2620,7,2620,0,4,1977,535000
6762818340,1990,8,1290,700,4,1966,529219
6762818539,3430,7,2230,1200,3,1988,524500
6762818877,1860,8,1860,0,3,1994,510000
6762819378,4060,9,2790,1270,4,2007,495000
6762819379,1780,7,1230,550,3,1979,495000
6762819746,1840,7,1840,0,3,1993,481500
6762819799,2450,9,2450,0,3,1990,480000
6762820152,2520,8,2520,0,4,1994,470000
6762820236,1990,8,1990,0,3,2004,467000
6762820300,2290,8,1420,870,3,1948,465000
6762820301,1590,8,1060,530,3,2014,465000
6762820640,1180,8,1180,0,3,2010,455000
6762820739,1260,8,1260,0,2,2006,452000
6762820857,2280,8,2280,0,3,2010,450000
6762821430,2120,7,1420,700,3,1959,436000
6762821499,2190,7,2190,0,4,2004,435000
6762822500,1690,7,1180,510,3,1985,410000
6762822877,1140,6,1140,0,2,1932,400000
6762823001,1680,8,1360,320,3,2009,399000
6762823197,1610,6,1610,0,5,1936,393000
6762823297,1610,7,1060,550,3,1970,390000
6762823371,2960,9,1940,1020,5,1986,389500
6762823424,1810,8,1210,600,3,1968,387000
6762823453,710,6,710,0,1,2015,385195
6762823813,2200,8,1480,720,4,1959,376000
6762824511,2290,9,2290,0,4,2007,359950
6762824680,1350,6,1350,0,2,1947,355000
6762825237,2100,7,2100,0,4,1993,344000
6762825282,1260,8,1260,0,3,1998,342000
6762825359,2630,9,2630,0,3,1988,340000
6762825888,1420,7,1100,320,3,1967,329922
6762825987,2040,8,2040,0,3,1985,325900
6762826056,1490,5,1490,0,3,1932,325000
6762826215,1380,7,1380,0,3,2000,322000
6762826517,1950,7,1950,0,4,2002,315000
6762826819,1980,6,1580,400,3,1932,308000
6762827208,1410,7,1410,0,3,1949,299950
6762827275,1730,8,1730,0,3,2004,299000
6762827323,1430,7,1430,0,2,1999,297000
6762827444,1790,7,1060,730,5,1915,294000
6762827567,1190,7,1190,0,3,1986,290000
6762828135,1190,7,1190,0,4,1946,276693
6762828328,1780,7,1780,0,3,1987,272450
6762828428,2330,7,1390,940,3,1986,270000
6762829425,1790,7,1480,310,3,2006,246950
6762829498,1020,7,1020,0,3,1978,245000
6762829659,2460,7,1230,1230,5,1957,240000
6762829933,1400,7,1400,0,3,1991,231200
6762830257,1540,7,1260,280,4,1966,221000
6762830704,1210,6,1210,0,3,1957,205000
6762830923,2170,7,2170,0,4,1952,195000
6762831409,1090,6,1090,0,3,1969,152500
6762831594,840,6,840,0,3,1959,96500
6762810075,4470,11,3230,1240,4,2010,2950000
6762810324,5490,12,2910,2580,4,1996,1790000
6762810578,2800,9,2800,0,4,2011,1470000
6762810743,2900,11,2900,0,4,1986,1340000
6762810973,2640,10,2640,0,3,1995,1220000
6762811021,3420,10,2410,1010,3,1991,1200000
6762811228,2910,10,1940,970,4,1932,1100000
6762811363,2960,8,1550,1410,5,1958,1050000
6762811517,2710,9,2080,630,3,1956,999000
6762811842,3200,8,2700,500,4,1980,935100
6762812411,3620,9,3620,0,5,2003,856000
6762812544,2390,8,1460,930,4,1931,845000
6762812787,2990,9,1560,1430,3,1976,820000
6762812848,2080,8,2080,0,3,1960,813000
6762813121,2840,10,2840,0,3,1999,790000
6762813379,3560,9,3560,0,4,2003,770000
6762813527,2540,9,2540,0,4,2009,759990
6762813536,2260,7,1130,1130,3,1941,759000
6762813641,3210,10,3210,0,4,2005,750000
6762814324,2490,8,1490,1000,4,1953,704000
6762814374,2440,7,2440,0,4,1947,700000
6762814625,2790,9,2790,0,4,1999,685100
6762814645,2210,7,1710,500,3,1909,685000
6762814755,1780,8,1780,0,3,1930,679000
6762814828,1240,7,1240,0,3,1957,675000
6762814932,2820,7,2380,440,5,1960,669950
6762815869,2680,8,1340,1340,4,1959,622000
6762816056,2440,8,1710,730,3,2005,613000
6762816439,1560,8,1560,0,3,2006,598500
6762816822,1670,7,1220,450,3,1974,580000
6762816823,1800,8,1420,380,3,1947,580000
6762816859,1250,7,980,270,3,1925,579500
6762816860,1070,7,830,240,2,1924,579100
6762817128,2360,8,1990,370,5,2006,569900
6762817259,1170,7,1170,0,4,1925,564000
6762818062,1770,7,1020,750,3,1963,538000
6762818070,2590,8,1640,950,4,1978,537250
6762818816,1840,7,1160,680,2,1914,513000
6762819506,2180,7,1090,1090,2,1947,490000
6762819581,1820,7,1820,0,3,1994,488500
6762819882,820,7,820,0,2,1939,478000
6762820302,1580,6,1580,0,3,1900,465000
6762820537,1730,7,1260,470,3,1976,459000
6762820858,1710,7,1040,670,4,1972,450000
6762820859,2710,8,2710,0,5,2014,450000
6762821020,1440,7,1440,0,3,1985,447000
6762821096,2110,8,1210,900,3,1956,445000
6762821680,1560,7,1260,300,3,1927,430000
6762822324,1710,7,1710,0,3,1990,415000
6762822592,1700,8,1700,0,2,1976,407000
6762822703,1270,7,1270,0,2,1909,404500
6762823138,1780,8,1350,430,3,1960,395000
6762823139,2510,8,2510,0,3,2005,395000
6762823905,1580,7,1580,0,3,2004,375000
6762825177,970,7,970,0,2,1947,345000
6762825178,1110,8,1110,0,2,2006,345000
6762825306,3070,8,2510,560,3,1928,340500
6762825427,800,6,800,0,2,1925,339950
6762825809,2020,8,1320,700,3,1969,330000
6762826057,1670,7,1100,570,3,1988,325000
6762826518,2500,7,1250,1250,3,1958,315000
6762826855,840,7,840,0,2,2006,306500
6762827247,2530,9,2530,0,3,1990,299250
6762827445,2300,7,1400,900,5,1969,294000
6762827626,760,6,760,0,2,1950,289950
6762827971,1560,7,1560,0,4,2003,280000
6762828223,1910,7,1000,910,3,1980,275000
6762828429,2490,7,1390,1100,4,1990,270000
6762828519,1320,6,880,440,3,1943,268950
6762828844,1190,6,1190,0,3,1947,260000
6762828938,2260,8,1130,1130,5,1960,258000
6762829255,1470,7,1470,0,4,1967,250000
6762829341,1470,6,1470,0,2,2005,249900
6762829780,1630,7,1630,0,4,2003,236000
6762829992,2180,7,2180,0,6,1980,230000
6762829993,1020,7,1020,0,3,1967,230000
6762830163,1460,7,1460,0,3,1981,225000
6762830164,830,6,830,0,2,1950,225000
6762830284,1230,7,1230,0,3,1986,220000
6762830335,860,6,860,0,3,1944,219900
6762830474,1400,6,1280,120,3,1954,214950
6762830944,2190,7,1390,800,3,1987,194250
6762830968,1340,6,1340,0,2,1940,192000
6762831508,1270,6,650,620,3,1942,134000
6762831572,760,5,760,0,2,1930,110000
6762810593,3090,9,3090,0,5,1953,1450000
6762810653,3080,8,1940,1140,4,1976,1400000
6762810724,3540,10,2000,1540,5,2005,1350000
6762812045,3860,10,3860,0,3,1984,903000
6762812170,2570,8,1580,990,4,1927,889000
6762813574,2290,8,2290,0,3,1984,753000
6762813922,2160,9,1540,620,3,2014,730000
6762813923,1870,7,1670,200,4,1940,730000
6762815166,1820,7,1120,700,3,1923,655000
6762815589,1940,7,1240,700,3,1964,635000
6762816205,2885,8,2885,0,4,1984,605000
6762816964,2514,8,2024,490,3,2007,575000
6762817125,2510,7,1600,910,5,1963,569950
6762817219,2620,8,2620,0,4,1996,565000
6762817442,1590,7,1190,400,3,1908,556000
6762817901,2060,8,2060,0,4,1995,543000
6762818617,1530,8,1480,50,2,2006,520000
6762818754,2100,8,2100,0,3,1986,515000
6762819280,1861,8,1578,283,3,2007,499000
6762819380,2460,8,2460,0,4,2004,495000
6762819507,2650,8,1610,1040,4,1976,490000
6762819659,1840,8,1340,500,3,1958,485000
6762819987,2480,8,2480,0,3,2001,475000
6762820044,1530,8,1530,0,3,2012,474950
6762820153,1310,7,1310,0,3,1987,470000
6762820576,1380,8,1050,330,2,2008,457000
6762821792,1480,7,1480,0,3,1925,427500
6762822260,1670,7,1310,360,3,1988,415900
6762822781,840,7,840,0,2,1948,401000
6762822878,1350,7,1350,0,3,1964,400000
6762823669,1300,6,1300,0,3,1943,380000
6762824092,2420,9,2420,0,4,1985,370000
6762824512,2542,8,2542,0,4,2014,359950
6762825360,2020,7,1070,950,4,1941,340000
6762825542,2475,7,2475,0,4,2014,335900
6762827797,1560,7,1560,0,3,1967,285000
6762828430,1520,7,1160,360,3,1988,270000
6762829327,1730,6,1730,0,5,1944,249950
6762829994,1340,7,1100,240,3,1985,230000
6762831438,1460,6,1460,0,4,1959,150000
6762810344,3560,10,3560,0,4,2014,1750000
6762815431,2990,8,2990,0,4,2004,644500
6762823002,1740,8,1740,0,3,2000,399000
6762824765,1250,8,1250,0,3,2004,353000
6762824921,2090,7,1390,700,3,1956,350000
6762812734,2560,8,1610,950,4,1929,825000
6762810528,4500,12,4500,0,4,1991,1520000
6762811877,5710,11,5710,0,4,2007,930000
6762812735,2520,9,1550,970,3,1990,825000
6762813354,3470,8,1750,1720,4,1962,772000
6762813598,2860,8,1530,1330,4,1989,750500
6762813881,2145,8,2145,0,3,1910,734000
6762814091,2900,9,2900,0,5,1989,720000
6762814434,2510,9,2510,0,3,2003,699950
6762814472,2420,7,1640,780,3,1947,697000
6762814570,2820,9,2820,0,3,2004,690000
6762814646,2340,8,1270,1070,4,1953,685000
6762814860,2590,10,2590,0,4,1993,674750
6762814963,2780,8,2780,0,3,1979,666000
6762815070,1570,8,1570,0,3,2014,660000
6762815291,1900,7,1500,400,2,1916,650000
6762815549,2850,8,2850,0,4,2008,637000
6762816066,2670,8,2670,0,4,1999,612000
6762816206,3220,8,3220,0,5,1972,605000
6762816393,2680,8,1340,1340,5,1976,599950
6762816421,1650,8,1650,0,3,2014,599000
6762816701,1450,7,1190,260,3,1939,585000
6762817477,2090,8,1420,670,5,1966,555000
6762817652,1340,7,1340,0,3,1960,550000
6762817750,1280,9,1040,240,3,2014,549900
6762818947,1200,7,1090,110,2,1927,508000
6762819149,2730,8,2730,0,4,1977,500000
6762819381,1650,7,1100,550,3,2012,495000
6762819800,2180,6,1730,450,4,1950,480000
6762819801,2080,7,2080,0,5,1963,480000
6762819883,1430,8,1160,270,3,2008,478000
6762820303,2000,7,1480,520,4,1930,465000
6762820641,1320,7,1320,0,4,1956,455000
6762820740,2190,7,2190,0,4,2007,452000
6762821005,1950,8,1530,420,3,1953,447500
6762821500,2130,8,2130,0,4,1986,435000
6762821501,2290,7,1290,1000,4,1959,435000
6762821621,1660,7,1660,0,3,1967,431000
6762821815,2350,7,2350,0,4,2001,426950
6762821907,1260,7,1260,0,3,2003,425000
6762822543,2655,8,2655,0,3,2013,409950
6762822957,1400,7,1400,0,3,1930,399950
6762823021,1780,8,1350,430,2,2005,398500
6762823140,1950,7,1950,0,4,1962,395000
6762823733,1240,7,1050,190,2,2007,379900
6762823906,1780,6,1050,730,3,1944,375000
6762824093,2100,9,2100,0,2,2005,370000
6762824143,1110,7,1110,0,3,1967,369950
6762824283,790,8,700,90,2,2003,365000
6762824351,920,8,800,120,2,2009,363000
6762825512,3200,8,3200,0,4,2003,337000
6762825671,2590,7,1750,840,5,1979,334000
6762826448,1120,7,1120,0,3,1917,316000
6762826611,1510,7,1010,500,3,1968,313000
6762826931,2660,7,2660,0,5,1961,305000
6762827336,1320,7,1320,0,2,1997,296000
6762827388,1300,6,1300,0,2,1960,295000
6762827488,1950,8,1950,0,3,1996,292000
6762827568,1560,8,1560,0,2,2002,290000
6762828114,1660,7,1110,550,4,1963,277500
6762828657,800,6,700,100,3,1949,265000
6762828658,1450,7,1180,270,3,1963,265000
6762828946,1600,7,1600,0,4,1986,257700
6762829131,1580,7,1040,540,3,1978,253000
6762829256,1620,7,1620,0,3,1966,250000
6762829257,800,6,800,0,2,1943,250000
6762829328,1670,7,1670,0,3,2014,249950
6762829552,1470,7,1470,0,3,1991,244000
6762829736,810,5,810,0,2,1938,238950
6762829839,1250,7,1250,0,3,1961,235000
6762829906,1710,6,1710,0,3,1941,233000
6762830571,1230,7,1230,0,3,1969,210000
6762831026,790,6,790,0,2,1944,189000
6762831318,1070,7,1070,0,3,1961,164000
6762811364,3500,10,2560,940,4,2000,1050000
6762811737,2450,9,1800,650,3,1922,952000
6762811891,3140,10,3140,0,6,1991,925850
6762811931,3560,9,3560,0,4,2014,922755
6762812407,3940,10,3940,0,3,2014,857326
6762812736,3370,9,3370,0,4,2006,825000
6762812991,1790,8,1790,0,4,1932,800000
6762814170,1920,7,1260,660,5,1951,715000
6762814571,2360,8,1560,800,3,1926,690000
6762814996,2330,7,1550,780,5,1972,665000
6762815071,2280,8,2280,0,3,1984,660000
6762815631,2990,8,2990,0,3,1978,632925
6762816077,1270,7,1100,170,2,1900,611000
6762817357,2060,8,2060,0,3,1984,560000
6762817653,1650,8,1650,0,4,1967,550000
6762817808,1657,7,1657,0,2,1910,546000
6762818289,3250,8,3250,0,4,2008,530000
6762818842,1430,7,980,450,3,1947,511000
6762818936,1960,7,1260,700,4,1926,509000
6762819055,1870,7,1250,620,3,1984,502000
6762819150,3010,8,3010,0,4,2006,500000
6762819382,1890,8,1890,0,3,1967,495000
6762819755,1920,7,1470,450,4,1966,481000
6762819988,2420,8,1530,890,3,1957,475000
6762820569,840,7,840,0,2,1908,457500
6762820585,2400,8,2400,0,4,2007,456500
6762820967,2280,7,1270,1010,6,1998,449500
6762821097,2100,7,1720,380,4,1924,445000
6762821502,2630,8,1330,1300,4,1956,435000
6762821735,3760,8,2740,1020,4,2007,429900
6762821908,1620,7,1620,0,4,1956,425000
6762822501,2280,7,2280,0,3,1978,410000
6762822665,2090,8,2090,0,4,1997,405000
6762822879,1850,7,1120,730,4,1958,400000
6762823034,1830,7,1830,0,3,1954,398000
6762823068,1710,7,1710,0,3,1952,397000
6762823226,2300,7,2300,0,4,1988,392000
6762823298,1650,8,1130,520,3,1979,390000
6762823299,2200,7,1270,930,3,1978,390000
6762823589,1760,8,1760,0,3,2014,382495
6762823619,1430,7,1110,320,2,1944,380950
6762823670,1840,7,1290,550,3,1971,380000
6762823671,980,7,980,0,2,1923,380000
6762823775,1700,7,850,850,4,1955,378500
6762824681,2160,7,1360,800,4,1983,355000
6762824737,3020,7,3020,0,6,1941,354000
6762824922,1380,7,930,450,3,1950,350000
6762825051,1690,7,1190,500,3,1976,349000
6762825179,960,7,960,0,3,1972,345000
6762825361,2140,8,2140,0,4,1930,340000
6762825441,1440,6,720,720,4,1947,339888
6762826058,1160,7,1160,0,3,1968,325000
6762827139,1550,8,1550,0,3,1965,300000
6762827240,1880,7,1880,0,3,1968,299500
6762827389,520,6,520,0,1,1918,295000
6762827390,1380,7,1380,0,3,1963,295000
6762827446,1420,7,960,460,3,2014,294000
6762827515,2350,7,1550,800,7,1962,291000
6762827569,2090,8,1360,730,4,1967,290000
6762827658,1580,7,1580,0,3,1954,289000
6762827972,2050,8,2050,0,4,1990,280000
6762828224,1480,7,1480,0,4,1957,275000
6762828284,1840,7,1210,630,4,1990,274900
6762828344,1880,7,1880,0,4,1993,272000
6762828968,1397,7,1397,0,3,1965,257000
6762829609,1150,6,1000,150,3,1951,241000
6762829728,1980,6,1980,0,4,1924,239000
6762829745,1650,7,1650,0,3,2004,238000
6762829840,1770,8,1250,520,4,1979,235000
6762829995,1510,7,1510,0,3,1985,230000
6762830165,940,7,940,0,2,1960,225000
6762831418,840,6,840,0,3,1921,151100
6762810294,3480,8,3480,0,4,2014,1850000
6762810812,3340,10,2550,790,3,1956,1300000
6762811304,2320,8,2040,280,3,1939,1070000
6762811580,2840,10,1920,920,4,1910,986000
6762811882,4030,9,4030,0,4,2002,929000
6762811929,3210,9,3210,0,5,2014,924000
6762812343,3050,10,3050,0,3,1997,865000
6762812493,2640,8,1640,1000,2,1963,850000
6762812494,2800,8,1400,1400,5,1970,850000
6762812654,3430,10,2390,1040,4,1986,832500
6762813044,2390,7,2140,250,4,1945,799000
6762813764,2070,7,1390,680,4,1962,741000
6762813788,3440,10,2190,1250,3,1979,740000
6762813894,2270,9,2270,0,4,1986,732350
6762814250,4070,10,4070,0,4,1998,710000
6762814682,2450,8,2450,0,4,1980,682000
6762815292,1870,8,1230,640,3,1925,650000
6762815293,2350,7,1740,610,3,2003,650000
6762815362,2980,10,2980,0,4,1994,649000
6762815590,4260,8,4100,160,4,1935,635000
6762815647,2270,7,2270,0,5,1905,631000
6762815980,1740,8,1740,0,3,1963,616000
6762816422,2590,7,1330,1260,5,1960,599000
6762816702,1760,7,920,840,4,1950,585000
6762816824,1870,8,1870,0,3,2009,580000
6762816965,3550,8,3550,0,5,1968,575000
6762816966,2270,9,2270,0,3,1990,575000
6762817358,2280,9,2280,0,3,1987,560000
6762817886,1560,7,1560,0,4,1969,544300
6762818479,2990,9,2990,0,3,2003,525000
6762818618,2590,8,1440,1150,3,1977,520000
6762818825,2260,7,2260,0,3,1909,512500
6762819038,2940,9,1870,1070,4,1996,503000
6762819327,1910,8,1910,0,3,1988,496600
6762819989,2220,8,2220,0,3,1987,475000
6762820410,1890,9,1890,0,3,1979,462000
6762821146,2430,8,2430,0,3,2007,443000
6762821503,1440,9,960,480,2,2004,435000
6762821504,2360,7,2360,0,3,1964,435000
6762822325,2380,8,1190,1190,3,1956,415000
6762822556,890,6,890,0,2,1918,409000
6762822666,2620,7,1520,1100,4,1955,405000
6762823035,1310,7,1310,0,3,1998,398000
6762823504,1250,6,1250,0,3,1970,385000
6762824000,1850,7,1100,750,3,1959,373000
6762824020,2330,7,1800,530,4,1980,372000
6762824284,1590,6,1590,0,4,1944,365000
6762824285,990,7,990,0,2,1949,365000
6762824682,1760,7,850,910,2,1926,355000
6762824923,1380,9,1160,220,3,2012,350000
6762825042,1670,7,1070,600,4,1955,349170
6762825362,1010,7,670,340,2,2003,340000
6762826294,1120,6,750,370,2,1929,320000
6762826371,2250,7,1750,500,5,1930,319450
6762826666,1780,7,1780,0,4,2001,311000
6762826812,840,6,840,0,2,1942,308500
6762826932,1950,8,1350,600,4,1979,305000
6762827036,1600,7,1600,0,3,1906,302000
6762827140,970,7,970,0,3,1982,300000
6762827141,2240,7,2240,0,3,2003,300000
6762827142,1210,7,1210,0,3,1975,300000
6762827570,1330,7,1330,0,4,1949,290000
6762827571,2780,8,1390,1390,5,1967,290000
6762827572,1650,7,1500,150,3,1962,290000
6762827727,1980,7,1170,810,4,1977,286285
6762827973,1310,7,1310,0,3,1968,280000
6762828489,1420,7,1420,0,3,1957,269900
6762829705,1560,7,1560,0,3,1979,239950
6762829729,1360,7,1360,0,3,1994,239000
6762829841,1690,5,1690,0,4,1930,235000
6762830806,1250,6,1250,0,2,1928,200000
6762830847,1340,6,1340,0,3,1944,199950
6762830877,1520,5,1520,0,3,1932,198500
6762830951,1010,6,1010,0,3,1943,194000
6762831290,1190,6,1190,0,3,1959,166950
6762831480,730,4,730,0,1,1926,140000
6762831613,860,6,860,0,3,1954,82000
6762810212,4280,11,2180,2100,4,1971,2050000
6762810282,2620,9,2620,0,3,1949,1880000
6762810545,5550,11,5550,0,4,2005,1500000
6762810619,2910,10,2910,0,4,2003,1430000
6762810854,3530,10,3530,0,4,2007,1280000
6762811229,3890,10,3890,0,5,1950,1100000
6762811278,3740,11,3740,0,4,2000,1080000
6762811467,2440,8,2440,0,5,1910,1010000
6762811585,2720,7,2720,0,2,1990,985000
6762811887,2900,9,1750,1150,4,1981,926500
6762813272,2630,9,2630,0,3,1987,778000
6762813343,2010,8,2010,0,4,1901,774000
6762813863,2470,8,2470,0,4,2004,735000
6762814141,1930,9,1230,700,3,1936,716500
6762814647,1480,8,1480,0,3,1963,685000
6762814671,3040,9,2420,620,4,2010,684000
6762814719,2510,8,1990,520,4,2013,680000
6762815591,2410,9,2410,0,4,1993,635000
6762816114,1390,7,1390,0,4,1926,610000
6762816140,2260,9,2260,0,4,1983,608700
6762816180,1160,7,910,250,2,1940,605125
6762816967,2520,8,2520,0,4,1980,575000
6762817359,1810,8,1350,460,4,1952,560000
6762817478,1550,7,1050,500,2,1941,555000
6762817541,1960,8,1960,0,3,1984,552321
6762817654,2550,8,1890,660,4,1982,550000
6762818755,1930,8,1930,0,2,2005,515000
6762818756,1640,7,1040,600,2,1937,515000
6762819151,2110,9,2110,0,3,1977,500000
6762819747,2140,7,1070,1070,3,1948,481500
6762820060,1780,7,1080,700,4,1969,473600
6762820304,3020,7,1510,1510,5,1959,465000
6762820305,2170,7,1420,750,4,1969,465000
6762820306,1430,7,1430,0,3,1953,465000
6762821098,1750,7,1750,0,3,1966,445000
6762821396,2120,7,2120,0,3,2000,437500
6762821600,1920,8,1920,0,3,2000,432000
6762821764,1760,8,1310,450,2,1950,428950
6762822104,1060,7,1060,0,3,1966,420000
6762822245,2280,8,2280,0,4,1991,416500
6762822502,1030,7,1030,0,2,1912,410000
6762823141,1590,7,1590,0,3,1966,395000
6762823300,1490,7,960,530,3,1993,390000
6762823301,2290,7,1190,1100,5,1965,390000
6762823907,1640,7,1640,0,3,1959,375000
6762823908,1410,6,1410,0,3,1983,375000
6762824189,2689,9,2689,0,4,2006,368000
6762824457,2390,9,2390,0,4,1999,360000
6762824683,2570,9,2570,0,4,1999,355000
6762824766,1780,7,1780,0,4,1967,353000
6762825180,1990,8,1410,580,3,1987,345000
6762825181,2020,7,2020,0,4,2012,345000
6762825254,1210,8,1000,210,3,2002,343000
6762825483,1530,6,910,620,4,1948,338000
6762825732,1820,7,1820,0,4,1969,331500
6762825938,1470,7,1130,340,3,1983,328000
6762826295,2150,8,1340,810,4,1992,320000
6762826519,700,6,700,0,1,1910,315000
6762826728,1010,7,1010,0,2,1981,310000
6762826809,1500,7,1500,0,2,1999,308625
6762827037,890,6,890,0,2,1947,302000
6762827143,1260,6,1260,0,3,1968,300000
6762827209,1580,7,1580,0,3,1954,299950
6762827798,1160,7,1160,0,3,1953,285000
6762827876,1650,7,1650,0,4,1964,282500
6762827974,880,6,880,0,2,1939,280000
6762828294,1400,7,1400,0,3,1958,274000
6762829499,1820,7,1420,400,3,1994,245000
6762829996,1470,4,1470,0,2,1932,230000
6762830394,710,6,710,0,2,1943,216500
6762830411,1380,7,1380,0,3,1946,215500
6762830744,1080,6,1080,0,2,1951,203000
6762830907,1120,7,1120,0,3,1976,195700
6762830924,1190,7,1190,0,3,1965,195000
6762830957,950,6,950,0,2,1924,193000
6762831201,1280,6,1280,0,3,1958,175000
6762831350,830,6,830,0,2,1920,160000
6762831471,980,6,980,0,3,1946,144000
6762810398,4910,10,3580,1330,6,1910,1680000
6762810931,4700,11,2660,2040,4,2002,1240000
6762811049,4340,11,4340,0,4,2003,1190000
6762811098,4270,10,4270,0,4,1994,1160000
6762811593,2790,9,2790,0,4,1987,982000
6762811606,3720,11,3720,0,4,2007,980000
6762812262,1220,7,1220,0,3,1955,875000
6762812263,3720,9,1930,1790,4,1960,875000
6762812423,3460,10,3460,0,4,2010,855000
6762812905,3020,9,3020,0,4,1956,808100
6762813029,2900,10,2900,0,3,1997,799950
6762813122,2640,10,2640,0,3,1996,790000
6762813174,2930,9,2930,0,3,2000,785000
6762813175,3270,9,3270,0,4,1993,785000
6762813789,2100,9,2100,0,3,1995,740000
6762814171,2570,9,2570,0,4,1998,715000
6762814277,1550,7,1550,0,4,1907,707500
6762814473,2820,7,1860,960,4,1928,697000
6762815072,2290,8,2290,0,4,1977,660000
6762815167,1270,7,1270,0,3,1906,655000
6762815294,2110,7,1530,580,4,1942,650000
6762815410,3340,8,3340,0,5,1975,645000
6762815981,3440,10,3440,0,4,2006,616000
6762816043,2880,8,1920,960,4,1981,614000
6762816394,2720,8,1510,1210,4,1952,599950
6762816578,2380,8,2380,0,4,2004,590000
6762817014,2060,9,2060,0,3,1988,574000
6762818757,1810,9,1810,0,3,1979,515000
6762819660,2900,9,2900,0,3,1986,485000
6762820109,2560,8,2560,0,3,1989,470950
6762820307,2590,8,2590,0,4,1986,465000
6762820597,2720,7,1700,1020,5,1968,456000
6762820860,1990,10,1520,470,3,1990,450000
6762820980,1270,7,1270,0,3,1903,449000
6762821099,3450,8,3450,0,4,2008,445000
6762821165,2710,7,2170,540,3,1980,442500
6762821270,1080,6,1080,0,2,1923,440000
6762821727,2320,8,2320,0,4,2004,429950
6762821757,1540,7,1090,450,3,1959,429000
6762822046,1420,7,1420,0,3,1968,421000
6762822326,2700,9,2700,0,4,1940,415000
6762822587,1860,8,1860,0,3,1929,407185
6762823737,1470,8,1160,310,3,2005,379770
6762824094,1980,8,1980,0,3,1991,370000
6762824513,2210,8,2210,0,3,2003,359950
6762824778,1760,6,1760,0,3,1900,352950
6762825428,2670,8,2170,500,4,1955,339950
6762825610,2390,7,1560,830,3,1953,335000
6762825810,2500,7,1250,1250,4,1966,330000
6762826169,2000,8,2000,0,3,1992,324360
6762826296,2190,8,2190,0,4,1978,320000
6762826297,1520,7,1520,0,3,1951,320000
6762827391,720,5,720,0,3,1924,295000
6762827573,1390,7,1390,0,3,1979,290000
6762827574,1340,7,1340,0,3,1963,290000
6762827704,1600,8,1600,0,3,2013,287000
6762828040,1400,6,1400,0,3,1962,279900
6762828097,1940,7,1940,0,4,1990,278000
6762828225,1610,6,1010,600,4,1969,275000
6762828579,1390,8,1390,0,3,2005,267000
6762829047,1140,7,1140,0,2,1954,255000
6762829390,1330,7,1330,0,3,1987,248000
6762829500,1010,7,1010,0,3,1955,245000
6762829501,670,6,670,0,2,1960,245000
6762829660,1770,8,1270,500,3,1978,240000
6762829997,1360,7,1020,340,3,1980,230000
6762830093,1280,6,1280,0,3,1916,227000
6762830206,1300,7,1300,0,3,1980,224500
6762830383,720,5,720,0,2,1942,217000
6762830925,1510,7,980,530,3,1979,195000
6762830926,1280,6,1280,0,2,1913,195000
6762831071,1010,6,1010,0,3,1953,185000
6762831147,960,7,960,0,3,1952,179950
6762831526,760,6,760,0,2,1949,129000
6762810443,3530,10,3530,0,5,2013,1610000
6762820861,1160,7,1040,120,3,1941,450000
6762826059,1310,7,1310,0,3,1998,325000
6762826595,1870,7,1870,0,4,2008,313999
6762826729,2242,8,2242,0,3,2012,310000
6762816166,2470,9,2470,0,3,1991,607000
6762824001,2990,7,1550,1440,3,2003,373000
6762825120,1590,6,1590,0,3,1953,346000
6762810222,2610,9,2610,0,3,2006,2000000
6762810491,6070,11,6070,0,5,2004,1570000
6762810674,3290,10,2190,1100,5,1938,1390000
6762810885,3230,10,2220,1010,3,1998,1260000
6762810906,3670,10,2530,1140,3,1983,1250000
6762810932,2660,9,1870,790,3,2007,1240000
6762811022,3940,8,2620,1320,4,1921,1200000
6762811127,3180,9,2500,680,4,2012,1150000
6762811279,2580,8,1780,800,4,1964,1080000
6762811428,3545,10,2610,935,3,2005,1030000
6762811468,1820,8,1820,0,4,1923,1010000
6762811717,3060,8,2460,600,4,1957,959750
6762812113,1490,7,1490,0,2,1963,898000
6762812674,2180,8,1370,810,4,1963,830000
6762812759,1210,8,780,430,2,2000,824000
6762814015,3040,10,3040,0,4,1987,725000
6762814092,2440,10,1640,800,3,1980,720000
6762814193,1720,8,1720,0,3,1908,713500
6762814375,2100,8,2100,0,3,1916,700000
6762814376,1940,7,1090,850,3,1926,700000
6762815497,1210,8,1210,0,3,1930,640000
6762816332,1110,6,970,140,2,1912,600000
6762816333,4300,10,2710,1590,4,1992,600000
6762816525,2640,7,1840,800,5,1925,593000
6762816775,2320,8,2320,0,3,2003,580500
6762816968,2040,8,2040,0,4,1996,575000
6762817850,1370,7,1370,0,4,1926,545000
6762818156,1090,8,1090,0,3,1929,535000
6762818558,1440,7,1440,0,3,1937,523000
6762818585,1730,8,1730,0,3,1988,521000
6762818619,2280,9,2280,0,3,1987,520000
6762818620,1430,8,1430,0,3,1985,520000
6762818878,1550,7,1550,0,5,1966,510000
6762818964,1360,7,1360,0,4,1945,507000
6762819310,1950,7,1550,400,4,1998,497950
6762819661,1420,7,1050,370,5,1964,485000
6762820154,2410,9,2410,0,4,1974,470000
6762820181,1820,9,1820,0,3,2014,469950
6762820215,1250,7,1250,0,2,1986,468000
6762820237,1690,7,1690,0,3,2004,467000
6762821021,1520,7,1520,0,3,1984,447000
6762821271,1650,7,1520,130,3,2007,440000
6762821350,1620,7,1620,0,2,1995,439000
6762821370,1600,7,1600,0,2,1954,438200
6762821431,2640,7,2640,0,4,2000,436000
6762821909,2180,7,1200,980,5,1955,425000
6762821910,1610,7,1610,0,3,1977,425000
6762822327,980,7,980,0,2,1947,415000
6762822880,1130,7,990,140,3,1941,400000
6762823302,2770,7,1900,870,3,1980,390000
6762823505,1370,8,1100,270,3,2006,385000
6762823748,2120,7,1060,1060,4,1950,379400
6762824002,1290,7,1290,0,3,1976,373000
6762824095,780,7,780,0,2,2009,370000
6762824144,2760,8,1400,1360,4,1997,369950
6762824377,1120,7,1120,0,3,1944,362000
6762824738,850,7,850,0,2,1949,354000
6762824924,940,6,940,0,3,1959,350000
6762824925,2506,8,2506,0,4,2007,350000
6762825444,970,7,970,0,3,1972,339300
6762825466,1610,7,1610,0,3,1974,338950
6762825484,1250,7,1250,0,3,1947,338000
6762825811,1070,7,1070,0,3,1969,330000
6762826520,1780,9,1780,0,4,2000,315000
6762827144,2110,7,1100,1010,5,1962,300000
6762827575,1420,8,1310,110,3,2007,290000
6762827886,1785,8,1785,0,4,2009,282000
6762827975,1990,8,1180,810,4,1978,280000
6762828066,2010,7,2010,0,3,1990,279000
6762828110,1240,8,1200,40,2,1967,277700
6762828711,1580,7,1050,530,3,1980,264500
6762829258,1160,7,890,270,2,2006,250000
6762829661,1620,8,1620,0,3,1987,240000
6762829893,1240,6,1240,0,3,1921,234000
6762830368,980,7,980,0,3,1956,218000
6762830572,1040,7,1040,0,3,1956,210000
6762830631,1210,7,1210,0,3,1967,208000
6762830927,1230,6,1230,0,3,1959,195000
6762831046,1020,6,1020,0,2,1983,187000
6762831469,800,6,800,0,2,1964,145000
6762831496,760,6,760,0,2,1950,135900
6762810122,3440,10,2260,1180,4,1931,2490000
6762810774,3440,9,2560,880,3,2005,1320000
6762811168,1910,9,1910,0,5,1906,1130000
6762811230,4010,11,4010,0,5,2003,1100000
6762811528,3500,9,2850,650,4,2014,998000
6762811661,4060,10,2890,1170,4,1953,970000
6762811982,3510,10,3510,0,4,1988,915000
6762812675,3700,9,2890,810,5,2011,830000
6762812737,3280,11,2670,610,3,1985,825000
6762813045,2510,8,2510,0,4,1969,799000
6762813695,3340,10,3340,0,4,2005,749950
6762814377,2400,7,1780,620,5,1928,700000
6762814909,2980,9,2980,0,3,2005,670000
6762815498,3220,8,3220,0,5,2003,640000
6762815639,3520,8,2100,1420,5,1985,632000
6762816579,2490,8,2490,0,3,1975,590000
6762816899,1560,7,1200,360,3,1989,577000
6762817028,3230,9,3230,0,4,2014,572115
6762817399,3370,9,3370,0,4,2014,559630
6762817447,1670,7,1670,0,3,1959,555565
6762817500,1740,7,870,870,4,1942,554950
6762817655,2100,7,1060,1040,4,1924,550000
6762818649,2440,7,2440,0,5,1974,519950
6762818758,1400,7,1150,250,2,1904,515000
6762819043,2710,8,2710,0,4,1968,502700
6762820308,2200,7,2060,140,4,1994,465000
6762820396,1430,8,1430,0,3,1964,462600
6762820577,1690,8,1690,0,3,1903,457000
6762820741,2716,9,2716,0,4,2014,452000
6762820862,1350,7,1350,0,3,1954,450000
6762821397,2680,8,2680,0,4,1998,437500
6762821681,1820,7,1220,600,4,1988,430000
6762822020,1970,7,1130,840,4,1920,423000
6762822958,3087,8,3087,0,3,2014,399950
6762823003,1170,7,1170,0,3,1952,399000
6762823672,1120,8,760,360,2,2004,380000
6762824096,2580,8,2580,0,4,1999,370000
6762824378,2310,8,2310,0,3,1986,362000
6762825878,1300,8,880,420,3,2008,329950
6762826521,840,7,840,0,2,1925,315000
6762827865,2130,8,1270,860,3,1978,283000
6762828989,1480,7,1480,0,3,1995,256000
6762829155,1680,7,1680,0,3,1989,252000
6762829259,1790,8,1790,0,3,1992,250000
6762829662,1380,7,1380,0,3,1988,240000
6762830285,1950,8,1950,0,4,1979,220000
6762830286,1290,7,1290,0,3,1983,220000
6762830807,1320,7,1320,0,2,1980,200000
6762831220,1100,6,1100,0,3,1926,174900
6762831310,1010,6,1010,0,3,1958,165000
6762810725,3600,9,2720,880,4,1947,1350000
6762811050,3480,11,3480,0,4,1984,1190000
6762811099,4290,10,3590,700,5,1927,1160000
6762811128,4740,11,4740,0,4,1990,1150000
6762811305,3240,9,2730,510,4,1968,1070000
6762811365,2350,10,2000,350,2,2007,1050000
6762811469,3610,9,2640,970,4,2007,1010000
6762811607,3010,9,3010,0,4,1973,980000
6762811770,4030,9,4030,0,4,1992,950000
6762812310,1920,8,1920,0,4,1907,870000
6762812930,3960,10,3960,0,4,2000,805000
6762813123,2560,7,1760,800,4,1949,790000
6762813436,3140,9,2570,570,4,1988,765000
6762813642,3410,8,2130,1280,7,1906,750000
6762813643,2310,8,1310,1000,4,1980,750000
6762813739,3130,10,3130,0,4,1990,745000
6762813893,2470,9,2470,0,3,1988,732500
6762814336,2910,9,2910,0,4,2003,701000
6762815026,1910,9,1910,0,3,2006,663000
6762815109,3090,8,3090,0,3,2007,659000
6762815190,1680,8,1120,560,2,2014,653500
6762815295,2208,8,2208,0,4,1917,650000
6762815296,2870,9,2870,0,3,2012,650000
6762815389,2990,9,2990,0,4,2000,645500
6762815499,2940,8,1640,1300,4,1955,640000
6762815913,2350,8,2350,0,4,1959,620000
6762816395,2600,8,1300,1300,5,1967,599950
6762817419,3030,9,3030,0,4,1987,557865
6762817656,1840,8,1840,0,3,1971,550000
6762817770,1500,7,1500,0,5,1929,549000
6762818290,3010,8,3010,0,4,2008,530000
6762818480,2440,8,1750,690,4,1960,525000
6762818536,1830,7,1830,0,2,2005,524950
6762819383,3390,8,3390,0,4,2014,495000
6762819428,1790,8,1790,0,3,1978,493000
6762819429,2120,7,1220,900,6,1925,493000
6762819508,1500,8,1220,280,3,2006,490000
6762819902,1900,6,1900,0,3,1919,476800
6762819990,2270,8,2270,0,3,1968,475000
6762820216,1570,7,820,750,3,1953,468000
6762820309,2560,9,1280,1280,3,1977,465000
6762820310,1510,8,1230,280,3,2001,465000
6762820474,2080,9,2080,0,4,1996,460000
6762820578,2800,8,2800,0,4,2002,457000
6762820863,2320,8,2320,0,3,1952,450000
6762820952,1880,7,1880,0,3,1902,449950
6762821100,2420,8,2420,0,5,2013,445000
6762821911,1070,7,830,240,2,1950,425000
6762822328,1550,7,830,720,2,1953,415000
6762822667,3370,7,3370,0,5,2006,405000
6762822744,1480,7,870,610,3,1926,402300
6762823004,790,6,790,0,2,1948,399000
6762823005,990,7,840,150,3,1924,399000
6762823080,1710,7,1100,610,3,1954,396500
6762823142,1010,7,1010,0,2,1918,395000
6762823143,1470,7,1470,0,3,1962,395000
6762823215,2195,7,1060,1135,4,1912,392450
6762823745,1110,7,1110,0,3,1980,379500
6762823814,1470,7,1470,0,3,1982,376000
6762824286,1160,7,1160,0,2,1950,365000
6762824379,2880,8,2880,0,5,2001,362000
6762824586,1000,7,740,260,3,1945,357500
6762825812,980,6,980,0,3,1953,330000
6762825911,940,6,940,0,2,1916,329000
6762826395,2770,8,1600,1170,4,1961,318700
6762827145,1100,6,1100,0,2,1920,300000
6762827324,1940,8,1940,0,3,1994,297000
6762827576,2423,8,2423,0,4,2005,290000
6762827833,1700,6,1700,0,3,1955,284700
6762827898,1340,5,1340,0,3,1945,281000
6762828226,1320,7,1320,0,3,1955,275000
6762828845,1790,7,1790,0,4,1993,260000
6762828890,1240,7,1240,0,3,1955,259950
6762829156,1340,6,1340,0,3,1994,252000
6762829502,1870,7,1870,0,4,1977,245000
6762829842,1660,7,1080,580,3,1959,235000
6762829931,1200,7,1200,0,2,1941,231500
6762830287,1660,7,1660,0,3,1973,220000
6762830896,1090,7,1090,0,2,1954,196700
6762831148,920,6,920,0,3,1969,179950
6762831396,1300,7,1300,0,3,2013,155000
6762831523,710,6,710,0,2,1943,129888
6762810079,5190,11,5190,0,5,2013,2900000
6762810458,3370,10,1920,1450,3,1980,1600000
6762810759,3130,10,2450,680,4,2014,1330000
6762810813,3400,9,2290,1110,3,1937,1300000
6762811023,4110,9,3130,980,4,1928,1200000
6762811231,4320,7,2880,1440,5,1973,1100000
6762812583,1680,9,1680,0,2,2009,840000
6762813046,1510,8,1510,0,3,1902,799000
6762813380,3820,9,2850,970,4,2014,770000
6762813437,3360,10,3360,0,4,1987,765000
6762813503,2850,8,2850,0,4,1998,760000
6762813942,1630,10,1330,300,2,2014,729999
6762814016,3780,9,1890,1890,5,1978,725000
6762814093,1580,8,1580,0,2,1921,720000
6762814326,2550,9,2550,0,4,1987,703770
6762814378,2580,9,2580,0,4,1999,700000
6762814648,1710,9,1140,570,3,2014,685000
6762815541,2250,7,1420,830,4,1924,637800
6762815682,2100,7,1240,860,4,1960,630000
6762816334,990,6,990,0,2,1935,600000
6762816484,2060,7,1180,880,3,1905,595000
6762816825,2150,8,2150,0,3,1988,580000
6762816826,1910,8,1910,0,3,2003,580000
6762817035,1860,7,1020,840,3,1920,572000
6762817657,1390,7,1390,0,3,1915,550000
6762817737,2380,9,2380,0,3,1988,549950
6762817851,1990,8,1990,0,3,2003,545000
6762818395,1530,7,1120,410,3,1958,526000
6762818678,1590,7,1190,400,5,1929,518000
6762818679,2070,8,1370,700,4,1969,518000
6762818879,1390,7,930,460,2,1947,510000
6762818880,1370,8,1370,0,3,1940,510000
6762818973,3880,7,3880,0,5,2004,506000
6762819329,2250,7,1550,700,4,1967,496500
6762819509,1660,8,1660,0,3,1965,490000
6762820072,1840,8,1290,550,3,1961,472800
6762820102,1450,7,950,500,4,1925,471000
6762820311,2760,7,1380,1380,3,1960,465000
6762820642,2090,8,2090,0,3,1989,455000
6762820981,1510,8,1510,0,2,2005,449000
6762821272,3080,9,3080,0,4,1993,440000
6762821389,1800,8,1800,0,3,2014,437718
6762821505,3380,8,2200,1180,3,1999,435000
6762821682,2030,8,2030,0,3,2003,430000
6762821912,790,7,790,0,2,1941,425000
6762822329,1280,7,1280,0,3,1985,415000
6762822330,2420,8,2420,0,3,1996,415000
6762822381,1210,8,1020,190,2,2007,414500
6762822503,1140,7,900,240,4,1970,410000
6762822581,1522,8,1248,274,3,2006,407500
6762822881,1510,7,1120,390,3,1960,400000
6762822882,2320,8,2320,0,6,1962,400000
6762822883,1340,8,1150,190,2,2008,400000
6762823040,2120,8,2120,0,4,1971,397950
6762823303,950,6,950,0,3,1947,390000
6762823738,2390,8,1620,770,4,1976,379750
6762823783,1000,7,1000,0,3,1947,378000
6762824097,1320,7,1320,0,3,1971,370000
6762824514,893,8,893,0,2,2007,359950
6762824620,1140,7,1140,0,3,1976,356000
6762824926,940,7,940,0,2,1950,350000
6762825020,1420,7,1420,0,4,1925,349950
6762825295,1130,7,1130,0,3,1961,341500
6762825363,1240,8,1240,0,3,2003,340000
6762825364,1200,6,1200,0,4,1972,340000
6762826060,790,7,790,0,2,1948,325000
6762826298,2410,7,1310,1100,6,1957,320000
6762826522,2080,7,1040,1040,2,1960,315000
6762826592,2210,7,1460,750,5,1963,314000
6762826617,1260,7,1260,0,3,1975,312620
6762826730,1040,7,870,170,2,1965,310000
6762826731,2320,7,2320,0,4,1976,310000
6762826782,1990,7,1990,0,3,1967,309950
6762826933,2470,7,1970,500,4,2009,305000
6762826934,2251,8,1390,861,4,1957,305000
6762826935,1763,8,1763,0,4,2012,305000
6762827844,860,7,860,0,2,1918,284000
6762828145,1450,7,1450,0,3,1998,276000
6762828227,1510,7,1510,0,3,1970,275000
6762828228,680,5,680,0,2,1906,275000
6762828431,1040,6,1040,0,2,1922,270000
6762828846,980,7,840,140,2,2001,260000
6762829143,1810,8,1810,0,3,1987,252500
6762829260,1440,6,1080,360,4,1918,250000
6762829261,1220,6,1220,0,4,1942,250000
6762829418,1270,7,1270,0,3,1916,247000
6762829503,1450,8,1450,0,2,1983,245000
6762829730,1470,7,1470,0,2,1986,239000
6762829737,1190,7,1190,0,2,1951,238950
6762830081,1120,7,1120,0,3,1963,227950
6762830527,1840,7,1040,800,3,1960,210500
6762830573,1260,7,820,440,3,1983,210000
6762830574,1200,6,1200,0,3,1905,210000
6762830660,1330,6,1330,0,3,1976,206990
6762830705,1130,7,1130,0,3,1954,205000
6762830808,680,5,680,0,1,1947,200000
6762831133,940,7,940,0,3,1959,180000
6762831291,1150,7,1150,0,3,1977,166600
6762831322,770,6,770,0,2,1951,163250
6762831529,980,6,980,0,2,1969,128000
6762810032,5770,11,5770,0,4,1980,3850000
6762810171,4760,9,3390,1370,4,1916,2250000
6762810516,5770,9,3160,2610,4,1949,1540000
6762811366,2950,7,1810,1140,4,1912,1050000
6762811448,2880,8,1690,1190,3,1980,1020000
6762811634,5470,11,4590,880,5,1976,975000
6762811820,2140,9,1900,240,3,1925,940000
6762812354,3520,10,3520,0,4,1992,864500
6762812584,2790,9,1680,1110,5,1959,840000
6762812882,2020,8,1210,810,4,1961,810000
6762812931,4600,9,3200,1400,5,2006,805000
6762813124,3180,9,3180,0,4,1976,790000
6762813969,1580,9,1580,0,3,2009,727000
6762815560,1660,7,1000,660,3,1939,635500
6762815683,3800,9,3800,0,3,1983,630000
6762816207,2910,8,2910,0,5,1940,605000
6762816485,2030,7,2030,0,3,2008,595000
6762816888,2280,9,2280,0,3,1984,577500
6762816969,1870,8,1870,0,3,2001,575000
6762817015,3240,8,3240,0,4,1998,574000
6762817220,1950,8,1950,0,2,2009,565000
6762817560,2010,8,2010,0,3,1994,551000
6762817852,3160,8,1930,1230,4,1991,545000
6762818291,2590,9,2590,0,4,2006,530000
6762818401,2520,8,1680,840,4,1965,525300
6762818559,3180,8,2120,1060,4,1967,523000
6762818690,1810,8,1810,0,3,1992,517500
6762819005,1100,7,1100,0,3,1908,505000
6762819510,1260,7,1260,0,3,1920,490000
6762819511,2990,8,2990,0,5,1997,490000
6762819590,2500,7,1800,700,4,1978,488000
6762820475,1720,7,1040,680,4,1929,460000
6762820476,880,7,880,0,2,1909,460000
6762820643,1300,7,1300,0,3,1969,455000
6762820689,1700,8,1700,0,3,1992,454000
6762821273,2880,9,2880,0,4,1987,440000
6762821609,1710,7,1710,0,5,1962,431650
6762821683,3000,9,3000,0,4,2001,430000
6762821684,2350,7,1600,750,3,1981,430000
6762821785,1340,7,1340,0,3,1985,427800
6762821913,1670,7,1670,0,2,1947,425000
6762823673,1870,7,1870,0,6,1968,380000
6762824098,2250,8,1280,970,5,1973,370000
6762824570,2200,7,1100,1100,4,1908,358000
6762824571,2460,8,2460,0,5,2011,358000
6762824581,810,7,810,0,2,1952,357950
6762825429,1890,7,1890,0,5,1944,339950
6762825468,1936,8,1936,0,3,2013,338900
6762825611,1090,8,960,130,3,2009,335000
6762826732,2190,7,2190,0,5,1947,310000
6762826733,1140,7,1140,0,3,1988,310000
6762826999,1920,8,1920,0,4,1992,303500
6762827276,830,7,830,0,2,2005,299000
6762827341,1720,8,1720,0,4,2000,295700
6762827845,1080,7,1080,0,3,1944,284000
6762827976,1640,7,1640,0,3,1995,280000
6762828345,1680,7,1680,0,3,1991,272000
6762828477,1610,7,1610,0,3,1988,269950
6762828603,1860,7,1860,0,3,1957,265500
6762828847,1520,7,1520,0,3,1986,260000
6762829144,1780,7,1250,530,3,1974,252500
6762829419,460,4,460,0,1,1937,247000
6762829553,960,6,960,0,2,1950,244000
6762829781,1560,7,1560,0,3,1975,236000
6762830227,940,6,940,0,3,1961,223000
6762830854,720,6,720,0,1,1930,199900
6762831072,1090,6,1090,0,3,1969,185000
6762831134,1010,6,1010,0,3,1920,180000
6762831385,590,5,590,0,2,1947,156000
6762812558,2980,7,2070,910,5,1921,842500
6762814379,2340,8,1610,730,4,1975,700000
6762825525,2500,7,2500,0,4,2003,336500
6762825981,2580,7,1880,700,6,1913,326000
6762826160,2160,8,2160,0,4,1978,324888
6762810478,2610,8,2610,0,3,1952,1580000
6762810775,6110,11,6110,0,4,2005,1320000
6762810787,3490,9,2610,880,4,2014,1310000
6762811890,3980,10,3980,0,4,2001,925900
6762812217,2560,8,1450,1110,4,1975,880000
6762812385,2180,8,1300,880,3,1947,860000
6762812530,2760,10,2760,0,4,2014,847093
6762812932,2690,10,2690,0,3,1997,805000
6762812992,2150,7,2150,0,4,1955,800000
6762813079,3330,9,2610,720,5,2008,795000
6762813238,3420,9,3420,0,4,2010,780000
6762813320,3220,10,3220,0,4,1993,775000
6762813790,2560,8,1480,1080,4,1959,740000
6762814266,3910,9,3130,780,4,2006,709950
6762814601,1760,7,1760,0,3,1927,688500
6762815732,2310,7,2310,0,3,1965,627000
6762816044,2830,9,2830,0,3,2010,614000
6762816335,2600,8,1340,1260,6,1963,600000
6762816336,1970,7,1500,470,4,1908,600000
6762816892,2870,9,2870,0,4,2008,577288
6762817049,2510,7,2510,0,3,2001,571000
6762817169,2630,8,1430,1200,4,1948,567000
6762817513,3440,8,1720,1720,5,1958,554000
6762817853,2820,9,2820,0,4,1998,545000
6762817854,2650,10,2650,0,4,2014,545000
6762817985,1610,7,1060,550,3,1929,540000
6762818481,2000,7,1680,320,3,1939,525000
6762819333,2180,7,2180,0,3,2010,496000
6762819573,2090,7,1200,890,3,1952,489000
6762819619,2714,9,2714,0,4,2014,485230
6762819991,2040,7,2040,0,5,1908,475000
6762820067,3430,10,2830,600,5,2002,473000
6762820644,1920,7,960,960,4,1954,455000
6762820706,1430,7,1430,0,3,1955,453000
6762820707,1160,7,970,190,2,2005,453000
6762821101,1460,6,780,680,4,1946,445000
6762821147,1810,7,1810,0,3,1968,443000
6762821274,2350,8,2350,0,4,1989,440000
6762821506,2170,7,1670,500,5,1930,435000
6762821809,1200,7,1200,0,3,1962,427000
6762821825,1630,7,830,800,2,1947,426000
6762822237,2000,7,2000,0,3,2010,417000
6762822504,1900,6,950,950,4,1914,410000
6762822548,1340,7,1040,300,3,1921,409500
6762822725,1240,8,1080,160,2,2009,403000
6762822884,2240,7,2240,0,4,1942,400000
6762823069,1000,7,1000,0,2,1939,397000
6762823087,1300,7,1300,0,3,1956,396000
6762823144,2240,7,2240,0,4,1944,395000
6762823572,1830,7,1060,770,4,1966,383000
6762823909,1040,7,1040,0,3,1955,375000
6762824190,2120,7,1060,1060,3,1966,368000
6762824599,1370,7,1370,0,3,1948,357000
6762825071,670,5,670,0,2,1942,348000
6762826405,2180,8,1680,500,4,1969,318000
6762826612,1550,6,1550,0,3,1925,313000
6762826667,1400,7,1000,400,3,1981,311000
6762826734,1140,7,1140,0,3,1950,310000
6762827017,3100,7,1790,1310,3,1963,302500
6762827345,2830,8,1690,1140,4,1982,295500
6762827392,1810,7,1810,0,4,1973,295000
6762827393,1810,8,1810,0,4,1999,295000
6762827665,1390,7,1390,0,4,2008,288790
6762827799,1060,5,1060,0,1,1935,285000
6762828047,1613,7,1613,0,4,2009,279500
6762828295,820,6,820,0,2,1954,274000
6762828346,1870,7,1870,0,4,2004,272000
6762828478,1950,7,1320,630,3,1975,269950
6762828527,1420,7,1080,340,4,1981,268500
6762828659,1120,8,1120,0,3,1999,265000
6762828712,1370,7,1370,0,3,1993,264500
6762829092,700,6,700,0,2,1949,254950
6762829329,1090,7,1090,0,3,1966,249950
6762829731,1210,7,1210,0,2,1952,239000
6762829732,680,7,680,0,2,2005,239000
6762829754,1370,6,1370,0,2,1950,237600
6762829873,1510,7,1510,0,3,1974,234950
6762829998,1500,7,1100,400,3,1980,230000
6762829999,1340,7,1340,0,3,1995,230000
6762830166,1590,7,1590,0,3,1989,225000
6762830288,1000,6,1000,0,3,1944,220000
6762830289,1600,7,1600,0,3,1962,220000
6762831073,980,7,980,0,3,1955,185000
6762810040,5020,10,3420,1600,3,1941,3600000
6762810492,5220,11,5220,0,5,2001,1570000
6762810675,2400,11,2400,0,3,1992,1390000
6762811574,4115,9,4115,0,5,2014,988830
6762812038,2930,10,2930,0,3,1988,905000
6762812264,2380,9,2240,140,4,1948,875000
6762812344,1530,8,1530,0,3,1955,865000
6762812495,2330,8,2330,0,4,1965,850000
6762812841,2990,9,2990,0,4,2014,814950
6762812883,2390,7,2390,0,3,1921,810000
6762813341,1750,7,1750,0,5,1903,774900
6762813381,1870,8,1870,0,3,2008,770000
6762813588,2660,10,2660,0,4,1994,751305
6762813592,3380,10,3380,0,3,1994,751000
6762814109,2190,8,2190,0,3,2014,719950
6762814602,2370,8,2370,0,4,1987,688100
6762815297,2850,7,1730,1120,4,1910,650000
6762815390,2390,10,2390,0,4,1988,645500
6762815435,3600,7,2400,1200,6,1971,643500
6762816161,2180,8,1700,480,4,2002,607010
6762816431,2350,8,2350,0,4,1993,598850
6762816515,1320,7,1090,230,3,1920,594000
6762816627,1390,7,1090,300,3,1947,589000
6762816827,1490,8,1220,270,3,2001,580000
6762817180,2730,8,2730,0,5,2014,565997
6762817221,2860,7,1800,1060,5,1965,565000
6762817771,2000,8,1120,880,3,1951,549000
6762817986,1680,7,1680,0,3,1926,540000
6762817987,3370,9,3370,0,5,2007,540000
6762818233,1260,7,1260,0,2,1926,531000
6762818292,2240,8,1740,500,4,1984,530000
6762818482,3960,9,2690,1270,5,1989,525000
6762818759,2890,7,2890,0,4,2006,515000
6762818881,2540,10,2540,0,3,1991,510000
6762818882,2740,7,1370,1370,5,1959,510000
6762818928,1590,8,1300,290,2,1994,509500
6762819006,1250,7,950,300,2,1920,505000
6762819512,2020,7,1710,310,4,1938,490000
6762819802,2360,7,1340,1020,3,1929,480000
6762819992,1620,7,1620,0,2,1981,475000
6762819993,1970,8,1390,580,4,1983,475000
6762820401,1540,7,1540,0,2,1948,462500
6762820521,1690,7,1690,0,3,1984,459800
6762820583,2820,7,1540,1280,3,1920,456700
6762820864,1180,7,1180,0,2,1910,450000
6762821102,1700,6,1080,620,4,1940,445000
6762821685,1810,7,1240,570,3,1976,430000
6762821914,2660,8,2660,0,4,1972,425000
6762822027,2550,9,2550,0,4,1990,422500
6762822255,1800,8,1800,0,3,1987,416000
6762823006,1430,7,1430,0,3,2007,399000
6762824287,1290,7,1290,0,3,1971,365000
6762824402,1630,8,1630,0,3,1987,360400
6762824515,1980,8,1980,0,3,1999,359950
6762824684,1250,7,1250,0,2,1948,355000
6762824807,2090,7,1670,420,3,2005,352000
6762825182,1030,6,1030,0,3,1921,345000
6762825270,1280,7,1280,0,3,1962,342450
6762825455,2840,8,2840,0,4,2001,339000
6762825698,1240,7,1240,0,5,1954,333000
6762826299,1240,8,1050,190,3,2009,320000
6762826300,1340,7,940,400,3,1987,320000
6762826523,1660,8,1660,0,3,1971,315000
6762826820,1960,8,1960,0,4,1989,308000
6762826845,1790,7,1390,400,3,1980,307000
6762827146,950,6,950,0,3,1929,300000
6762827210,1570,7,1570,0,3,2005,299950
6762827277,1400,8,1160,240,2,2008,299000
6762827462,1020,7,1020,0,3,1940,293000
6762828067,1520,7,1520,0,3,1952,279000
6762828115,2620,7,2620,0,3,2010,277500
6762828229,1370,7,1150,220,3,1930,275000
6762828544,1600,7,1600,0,3,1999,268000
6762828588,1810,7,1810,0,3,2004,266490
6762829048,960,6,580,380,4,1949,255000
6762829049,620,6,620,0,2,1941,255000
6762829157,1940,8,1940,0,4,1974,252000
6762829262,2300,7,2300,0,3,1960,250000
6762829263,1100,5,1100,0,3,1917,250000
6762829264,1470,6,1470,0,3,1942,250000
6762830167,1390,6,1390,0,3,1976,225000
6762830347,1080,7,1080,0,3,1953,219000
6762830575,1500,7,1500,0,4,1999,210000
6762830576,1400,7,1400,0,3,1964,210000
6762831372,990,7,990,0,3,1962,158000
6762831379,870,6,870,0,1,1939,157000
6762831500,830,6,830,0,2,1943,135000
6762810142,4090,11,3400,690,4,1926,2400000
6762810146,3220,10,3220,0,4,1969,2380000
6762811367,3490,9,3170,320,3,1924,1050000
6762811470,3350,9,2550,800,4,2007,1010000
6762811518,2830,8,1830,1000,3,1962,999000
6762811711,2010,9,1450,560,3,1955,960000
6762812075,1240,7,1240,0,2,1954,900000
6762812597,3420,9,3420,0,4,2002,839900
6762813148,2680,8,2680,0,4,1977,788000
6762813382,2230,8,1630,600,3,1918,770000
6762813791,2710,10,2000,710,3,1978,740000
6762814125,2280,8,2280,0,3,1949,718000
6762814251,2000,7,1000,1000,4,1956,710000
6762814305,1820,7,1820,0,4,1947,705000
6762814380,2350,8,2350,0,3,2012,700000
6762814572,1770,8,1770,0,3,1999,690000
6762814948,2130,9,2130,0,3,1953,667500
6762815110,1980,8,1980,0,4,1938,659000
6762816072,1220,8,1220,0,1,1946,611900
6762816271,2080,8,2080,0,4,2001,601000
6762816486,2100,7,1400,700,4,1907,595000
6762816904,2630,8,2630,0,4,2004,576925
6762817087,2180,9,2180,0,3,1984,570000
6762817658,1880,8,1410,470,3,1980,550000
6762817911,1920,8,1600,320,3,2004,542500
6762818293,2030,8,2030,0,3,1983,530000
6762818359,1260,7,1120,140,2,1925,528000
6762818483,1430,7,1130,300,4,1945,525000
6762818621,2040,7,1020,1020,5,1961,520000
6762818652,2390,8,2390,0,3,2008,519500
6762818691,1190,7,1190,0,3,1943,517500
6762818760,2430,8,2430,0,3,2001,515000
6762818761,1810,7,1010,800,3,1926,515000
6762818940,1800,7,1800,0,4,1950,508500
6762818968,2100,8,1700,400,3,1989,506400
6762819384,1810,7,1810,0,5,1915,495000
6762820312,2300,8,1420,880,4,1979,465000
6762820477,1820,7,1240,580,2,1956,460000
6762821275,1440,7,1440,0,3,2003,440000
6762821915,1180,6,1030,150,3,1940,425000
6762821916,1980,7,1330,650,4,1968,425000
6762822331,1630,7,1630,0,3,1952,415000
6762822332,1640,7,1190,450,3,1972,415000
6762822333,1090,7,1090,0,3,1966,415000
6762822413,920,7,920,0,2,1948,412133
6762823070,1640,7,1640,0,3,1967,397000
6762823209,1540,7,1540,0,3,1957,392500
6762823234,1450,7,1450,0,3,1987,391500
6762823598,1070,8,1070,0,2,2005,382000
6762823784,1700,8,1700,0,2,2009,378000
6762823910,1930,7,1330,600,3,1961,375000
6762823911,1600,8,1600,0,3,2005,375000
6762824241,2030,8,2030,0,4,2003,365500
6762824685,1810,7,1070,740,3,2001,355000
6762824808,2650,9,2650,0,4,1998,352000
6762825365,2580,7,1630,950,3,1963,340000
6762825699,1260,7,1260,0,3,1999,333000
6762826061,2280,8,2280,0,4,1987,325000
6762826524,1700,7,1250,450,3,1956,315000
6762826598,1610,8,1610,0,3,1974,313500
6762826643,2280,8,2280,0,3,2008,312000
6762827278,1850,7,1850,0,3,2005,299000
6762827447,2060,7,2060,0,3,1938,294000
6762827577,1240,6,1240,0,1,1910,290000
6762827578,550,6,550,0,1,1916,290000
6762827579,1470,7,1040,430,3,1953,290000
6762828510,1010,7,1010,0,2,1923,269000
6762828751,1500,7,1060,440,4,1979,262500
6762829158,1540,7,1540,0,3,1984,252000
6762829265,1430,7,990,440,3,1980,250000
6762829363,1200,6,1060,140,4,1919,249000
6762829442,1650,8,1290,360,3,1990,246000
6762829663,1078,7,1078,0,2,1990,240000
6762829907,1400,7,1400,0,3,1974,233000
6762830447,1690,7,1690,0,3,1969,215000
6762830671,1720,7,1720,0,4,1959,206000
6762830745,1370,7,1080,290,3,1958,203000
6762830928,800,6,800,0,2,1918,195000
6762830958,680,5,680,0,2,1951,193000
6762830996,1200,6,1200,0,3,1953,190000
6762831074,1390,7,1390,0,2,1969,185000
6762831256,810,6,810,0,2,1944,170000
6762810063,3930,8,2330,1600,3,1957,3070000
6762810144,6330,13,4900,1430,4,2000,2390000
6762810399,4830,10,3720,1110,5,2014,1680000
6762810579,3030,9,2380,650,4,2003,1470000
6762811129,4400,11,4400,0,4,1988,1150000
6762811562,3140,10,3140,0,4,1988,990000
6762811701,2590,8,2590,0,5,1909,961000
6762811951,2590,9,2590,0,3,1983,920000
6762812160,3370,8,3370,0,4,2014,890000
6762812218,4600,10,3180,1420,5,2007,880000
6762812857,3970,9,2860,1110,5,2004,811500
6762812911,3340,9,3340,0,4,1996,808000
6762812933,2350,7,1650,700,5,1924,805000
6762812934,3350,9,2020,1330,4,1979,805000
6762813383,2730,7,1460,1270,4,1955,770000
6762813696,2370,9,2080,290,4,2008,749950
6762814381,1679,9,1679,0,2,2001,700000
6762814573,2230,7,1510,720,4,1922,690000
6762815298,3960,9,2500,1460,5,1996,650000
6762815353,3730,9,2230,1500,3,1990,649500
6762815805,1390,8,1165,225,2,2007,625000
6762815971,2490,8,2020,470,3,1999,616950
6762816828,1040,7,1040,0,2,1926,580000
6762817360,2720,8,2240,480,4,1976,560000
6762817361,2090,9,2090,0,3,1992,560000
6762818193,2280,7,2280,0,5,1992,534000
6762818548,2140,8,1440,700,3,1961,524000
6762819152,3720,9,2090,1630,5,1986,500000
6762819328,2020,8,1350,670,4,1961,496600
6762819513,1560,7,1160,400,3,1989,490000
6762819863,1330,8,1060,270,2,2005,479000
6762820478,2090,7,2090,0,4,1984,460000
6762820579,2060,7,1420,640,2,1940,457000
6762820645,1350,8,1350,0,2,2013,455000
6762820742,1580,7,960,620,4,1963,452000
6762821048,1880,7,940,940,3,1941,445500
6762821103,1850,7,1850,0,3,1985,445000
6762821276,1610,7,1610,0,3,1903,440000
6762821361,2470,7,2470,0,4,1991,438950
6762821507,1560,8,1080,480,2,2008,435000
6762821582,1470,8,1470,0,3,1963,432500
6762822047,1310,7,1310,0,4,1966,421000
6762822188,720,6,720,0,2,1943,419000
6762822201,2906,9,2906,0,4,2014,418395
6762822505,1410,7,1410,0,3,1987,410000
6762823036,1480,6,1480,0,3,1925,398000
6762823402,1370,8,1100,270,3,2006,388000
6762823506,1680,8,1340,340,3,1960,385000
6762823507,2560,8,2560,0,4,2007,385000
6762823912,1430,7,1430,0,3,1981,375000
6762824099,1750,7,1170,580,3,1979,370000
6762824236,2020,7,1300,720,4,1961,366000
6762824288,1520,5,1520,0,4,1948,365000
6762824516,2690,7,2690,0,4,2007,359950
6762824686,2550,7,1850,700,3,1959,355000
6762824927,1550,7,1550,0,3,1954,350000
6762825052,1250,7,1040,210,2,2007,349000
6762825283,2380,8,2380,0,4,1993,342000
6762825366,3400,7,2050,1350,3,1979,340000
6762825485,2090,7,1370,720,4,1986,338000
6762825912,2450,8,2450,0,3,1985,329000
6762826234,2020,7,2020,0,3,2012,321000
6762826411,2770,7,1770,1000,3,1925,317625
6762826525,1410,7,1180,230,3,2007,315000
6762826936,2100,8,2100,0,3,1994,305000
6762827147,1760,7,1760,0,3,1991,300000
6762827325,1280,7,1280,0,2,1996,297000
6762827326,1790,7,1050,740,4,1951,297000
6762827448,1650,7,1250,400,3,1957,294000
6762827489,2910,7,1600,1310,4,1998,292000
6762827580,1990,7,1870,120,4,1929,290000
6762827977,1770,7,1240,530,3,1978,280000
6762828347,2789,7,2789,0,4,2007,272000
6762828752,1140,7,1140,0,2,1949,262500
6762829342,1380,5,1380,0,3,1939,249900
6762830000,1260,7,1020,240,2,1983,230000
6762830036,1160,7,1160,0,2,1972,229950
6762830369,1610,8,1280,330,3,1968,218000
6762830494,1000,6,1000,0,2,1961,213000
6762830672,1280,7,1280,0,2,2005,206000
6762830706,1870,8,1870,0,3,1993,205000
6762830759,1420,6,1420,0,3,1990,202000
6762830997,1100,6,1100,0,3,1942,190000
6762830998,880,6,880,0,2,1943,190000
6762831075,1280,6,1280,0,3,1985,185000
6762831149,1100,7,780,320,2,1982,179950
6762810305,4510,12,4510,0,4,1998,1820000
6762810415,4010,8,2090,1920,6,1955,1650000
6762810744,5050,10,3260,1790,4,2000,1340000
6762811130,3230,7,3230,0,3,1925,1150000
6762811232,4090,10,2090,2000,5,1986,1100000
6762811280,3230,10,3230,0,5,2007,1080000
6762811771,2500,8,1700,800,4,1969,950000
6762811772,3700,11,3700,0,4,2006,950000
6762812191,2640,8,1960,680,3,1976,885000
6762812219,2510,9,1830,680,4,1953,880000
6762812536,3020,10,3020,0,4,1990,845800
6762812993,1510,8,1230,280,3,1910,800000
6762813504,3180,10,3180,0,5,1997,760000
6762813765,4380,8,2780,1600,3,1900,740500
6762813864,1640,9,1640,0,4,1911,735000
6762813965,1240,7,1240,0,2,1952,727500
6762814017,2130,7,1730,400,4,1916,725000
6762814042,2270,8,2270,0,4,1909,724950
6762814172,3060,10,2460,600,3,1994,715000
6762814506,2630,9,2030,600,3,2008,695000
6762814863,2780,9,2780,0,4,1985,674250
6762815073,3160,9,3160,0,5,2014,660000
6762815101,2990,10,2990,0,3,2006,659950
6762815500,2260,9,2260,0,4,2004,640000
6762815540,3340,9,2500,840,5,2014,637850
6762815544,2120,9,2120,0,4,2005,637250
6762815719,2830,7,1710,1120,5,1960,628000
6762816337,2990,8,2990,0,4,2004,600000
6762816703,2480,8,1860,620,5,1979,585000
6762816773,1930,8,1430,500,2,1951,581000
6762816869,1800,7,1800,0,3,1906,579000
6762817088,2420,9,2420,0,3,1990,570000
6762817659,2440,7,2440,0,3,1949,550000
6762817882,1990,8,1990,0,3,2004,544900
6762818199,1520,7,1370,150,4,1960,533250
6762818294,2100,7,2100,0,3,1955,530000
6762819591,2180,9,2180,0,3,1990,488000
6762819756,1620,7,920,700,2,1924,481000
6762819884,1210,7,1210,0,3,1976,478000
6762819913,1140,8,1140,0,2,1999,476000
6762819917,1880,7,1090,790,4,1944,475999
6762820155,1400,7,1400,0,3,1929,470000
6762820865,1570,7,1570,0,4,1960,450000
6762820866,2240,8,2100,140,3,2014,450000
6762821194,2000,6,1150,850,5,1987,441000
6762822213,2080,8,1360,720,3,1978,418000
6762822214,3266,8,3266,0,4,2014,418000
6762822450,1110,6,740,370,2,1916,410500
6762822668,1520,7,1140,380,3,1975,405000
6762823145,2500,9,2500,0,4,2002,395000
6762823304,2690,7,2690,0,4,1940,390000
6762823305,2560,8,2560,0,4,1989,390000
6762823425,1010,8,1010,0,2,1999,387000
6762823674,2864,8,2864,0,4,2014,380000
6762823913,2120,8,2120,0,3,1983,375000
6762823914,1000,7,1000,0,3,1947,375000
6762824289,920,6,920,0,2,1910,365000
6762825127,1930,8,1930,0,3,2014,345500
6762825183,1340,7,1340,0,3,1960,345000
6762825700,1520,7,1520,0,3,2009,333000
6762826382,2380,8,1760,620,4,1979,319000
6762826383,2110,7,2110,0,3,1978,319000
6762826526,2940,8,1780,1160,6,1978,315000
6762826527,900,6,760,140,2,1941,315000
6762826937,2430,8,2430,0,4,2002,305000
6762827018,1990,8,1990,0,4,1994,302500
6762827241,1600,7,1080,520,4,1979,299500
6762827306,2420,8,2420,0,4,2003,298000
6762827642,1760,7,1760,0,3,1995,289200
6762828068,1450,7,1450,0,3,2011,279000
6762828109,2100,7,2100,0,3,1992,277950
6762828296,2090,9,1670,420,4,1973,274000
6762828562,1090,7,1090,0,3,1967,267500
6762829266,1420,7,1420,0,2,1953,250000
6762830168,1550,7,1550,0,3,1948,225000
6762830169,1410,7,980,430,3,1962,225000
6762830348,809,7,809,0,2,2003,219000
6762830375,1070,7,1070,0,2,1980,217500
6762830497,1570,5,1570,0,3,1922,212644
6762830615,1250,7,1250,0,3,1967,209000
6762830809,1480,6,940,540,3,1947,200000
6762830943,1100,7,1100,0,3,1967,194820
6762810416,2750,7,1620,1130,3,1959,1650000
6762815438,2030,8,1400,630,3,1965,643000
6762823508,1970,8,1540,430,4,1977,385000
6762825658,980,8,980,0,2,2008,334900
6762828520,800,6,800,0,4,1943,268750
6762828728,1540,6,770,770,3,1951,263500
6762829504,670,6,670,0,2,1960,245000
6762816385,1620,7,1620,0,3,1928,599995
6762820743,1690,7,1690,0,3,2004,452000
6762822764,1720,7,1160,560,3,1969,402000
6762831119,900,6,900,0,2,1941,180250
6762810058,4490,12,4490,0,3,1993,3120000
6762810111,5410,10,5050,360,5,1941,2540000
6762810594,4300,11,4300,0,4,2014,1450000
6762810760,2280,9,2280,0,3,1926,1330000
6762810814,6563,10,5153,1410,6,2002,1300000
6762811542,3970,9,2970,1000,5,1979,995000
6762811773,2210,7,1460,750,4,1952,950000
6762811774,2940,9,2340,600,5,1909,950000
6762812028,1340,9,1340,0,3,1927,907000
6762812039,3370,10,3370,0,4,1981,905000
6762812400,3460,9,3460,0,5,2011,858450
6762812994,2510,9,2200,310,4,1967,800000
6762813321,3060,9,3060,0,4,2004,775000
6762813340,3410,10,3410,0,4,2004,774950
6762814094,3170,9,3170,0,3,2005,720000
6762815652,1909,8,1766,143,3,2006,630500
6762815806,1970,8,1470,500,3,1959,625000
6762816605,2080,8,2080,0,3,1982,589950
6762816613,3190,10,3190,0,4,2005,589450
6762817043,1920,7,960,960,4,1939,571500
6762817089,2890,9,2890,0,4,2005,570000
6762817141,1990,7,1230,760,3,1908,569000
6762817362,2430,8,1270,1160,3,1978,560000
6762818586,2020,8,1550,470,4,1976,521000
6762818622,1670,7,1150,520,3,1961,520000
6762818762,2700,9,2700,0,4,2009,515000
6762819385,1280,8,1080,200,3,2008,495000
6762819574,850,7,850,0,2,1927,489000
6762819803,2870,9,2870,0,4,1977,480000
6762819994,2160,8,2160,0,4,1981,475000
6762819995,1240,7,1240,0,3,1959,475000
6762820580,1170,7,1170,0,3,1924,457000
6762820867,2020,7,1170,850,3,1956,450000
6762821127,2020,7,1330,690,3,1958,444950
6762821686,2020,8,1680,340,3,2008,430000
6762821777,1980,7,1280,700,2,1977,428000
6762822334,1570,8,1570,0,3,1930,415000
6762822506,1530,7,1180,350,3,1988,410000
6762822885,1510,7,1510,0,3,1959,400000
6762823007,2800,9,2800,0,4,2005,399000
6762823181,2620,7,2620,0,3,1982,394250
6762823306,2500,8,1770,730,3,1986,390000
6762823723,2580,8,2580,0,4,2005,379950
6762823746,960,7,960,0,2,1949,379500
6762824458,1850,7,1850,0,4,1969,360000
6762824459,1950,7,1950,0,4,2004,360000
6762824621,1430,7,1010,420,2,1991,356000
6762824928,1870,7,1120,750,3,1923,350000
6762825367,1270,8,1270,0,2,2012,340000
6762825612,2330,8,2330,0,4,1998,335000
6762825613,1490,7,1490,0,3,1967,335000
6762825738,1080,7,580,500,3,1954,331000
6762825739,1300,7,1300,0,3,1986,331000
6762825879,2080,7,1080,1000,3,1971,329950
6762826062,2410,7,1510,900,4,1957,325000
6762826188,1290,7,1290,0,3,1976,323000
6762826528,1850,7,1140,710,4,1960,315000
6762826983,1790,7,1390,400,3,1974,304500
6762827226,2100,7,2100,0,3,1984,299900
6762827433,1788,7,1788,0,4,1990,294400
6762827581,1760,7,1760,0,3,1998,290000
6762827582,1590,7,910,680,2,1983,290000
6762828348,2430,8,2150,280,3,1983,272000
6762828848,1830,7,1060,770,4,1962,260000
6762829050,1230,7,1230,0,3,1979,255000
6762829343,560,6,560,0,2,1944,249900
6762829420,1750,5,1750,0,4,1943,247000
6762829664,1190,7,1190,0,3,1994,240000
6762829894,1420,7,1420,0,3,1966,234000
6762830170,960,5,960,0,3,1954,225000
6762830290,1000,6,1000,0,3,1933,220000
6762830358,1080,7,1080,0,3,1968,218250
6762830403,1730,7,1180,550,3,1961,216000
6762830448,1260,7,1260,0,3,1979,215000
6762830577,970,7,970,0,2,1968,210000
6762830625,840,5,840,0,2,1938,208417
6762830838,860,7,860,0,2,1949,199988
6762831111,1160,5,1160,0,3,1950,182000
6762831369,960,6,960,0,3,1950,158800
6762810203,5150,11,4360,790,4,1997,2140000
6762810400,7620,11,5980,1640,4,2005,1680000
6762810788,3650,9,1860,1790,5,1978,1310000
6762810907,4980,9,3080,1900,4,1982,1250000
6762810956,3440,9,3440,0,5,1901,1230000
6762811617,2390,9,1690,700,3,1936,978000
6762811914,3420,9,2520,900,5,2008,925000
6762813125,2050,8,2050,0,3,1991,790000
6762813322,2090,7,1090,1000,4,1916,775000
6762813323,1160,5,580,580,3,1931,775000
6762813544,2610,7,1630,980,3,1985,757000
6762813644,2640,7,1840,800,4,1911,750000
6762814018,2700,8,1450,1250,4,1953,725000
6762814282,2920,9,1690,1230,4,1977,707000
6762814382,1730,7,1250,480,4,1945,700000
6762814829,2130,7,1430,700,3,1922,675000
6762815018,1530,7,1530,0,4,1912,664000
6762815019,3190,8,3190,0,6,1979,664000
6762815411,2770,8,1570,1200,2,1969,645000
6762815592,3610,8,1950,1660,3,1998,635000
6762815974,1880,8,1760,120,4,1909,616500
6762816540,1560,8,1560,0,3,1940,592000
6762816970,3840,7,2530,1310,8,1961,575000
6762817294,2060,7,1460,600,4,1922,562000
6762817363,1530,8,1200,330,3,2007,560000
6762817407,1650,8,1350,300,2,2015,559000
6762817514,820,7,820,0,2,1968,554000
6762817772,1340,7,1340,0,3,1905,549000
6762818295,2000,7,1220,780,4,1944,530000
6762818883,2010,8,1310,700,4,1959,510000
6762819007,2420,8,2420,0,4,2013,505000
6762819153,2760,8,1800,960,4,1978,500000
6762819154,2690,7,2690,0,4,1949,500000
6762819155,2280,7,2280,0,4,1956,500000
6762819592,1600,7,1600,0,3,1909,488000
6762820068,1620,7,1620,0,3,1987,473000
6762820646,1760,8,1760,0,3,1959,455000
6762821166,1840,7,1390,450,4,1973,442500
6762821336,1130,8,910,220,2,2008,439108
6762821398,1760,7,1290,470,3,1988,437500
6762821399,1630,7,1630,0,3,1969,437500
6762821608,1400,8,1400,0,2,1957,431750
6762821987,3266,8,3266,0,4,2014,424950
6762822172,1400,8,1400,0,3,2007,419500
6762822669,2360,7,1390,970,4,1978,405000
6762822787,2578,9,2578,0,4,2014,400950
6762823008,700,6,700,0,2,1946,399000
6762823088,1980,7,1080,900,3,1949,396000
6762823307,1910,7,1410,500,3,1978,390000
6762824100,1270,7,1270,0,2,2000,370000
6762824460,2230,7,1390,840,6,1969,360000
6762824767,1912,8,1912,0,4,2012,353000
6762825021,1230,6,1230,0,1,1918,349950
6762825184,1620,6,1620,0,3,1958,345000
6762825368,1710,6,1310,400,3,1949,340000
6762825982,2290,7,1390,900,4,1963,326000
6762825988,1540,7,1190,350,3,1959,325500
6762826301,1550,8,1550,0,2,2008,320000
6762826938,1000,7,1000,0,2,1947,305000
6762827279,1820,7,1220,600,4,1975,299000
6762827866,1820,7,1520,300,3,1920,283000
6762828069,1640,7,1640,0,3,2003,279000
6762828939,2710,7,1710,1000,4,1967,258000
6762830094,1150,7,1150,0,1,1962,227000
6762830370,1640,7,950,690,4,1963,218000
6762830397,1650,8,1650,0,3,1985,216300
6762830929,720,6,720,0,2,1947,195000
6762830999,1520,7,1520,0,3,1967,190000
6762831018,920,6,920,0,3,1969,189950
6762831439,720,5,720,0,2,1982,150000
6762831440,720,5,720,0,2,1915,150000
6762810205,3190,10,3190,0,4,1982,2130000
6762810356,4440,10,3240,1200,4,1965,1730000
6762810444,4270,11,4270,0,4,1996,1610000
6762810499,2870,8,2870,0,5,1962,1560000
6762810546,3770,9,2890,880,4,1916,1500000
6762811860,1870,7,1870,0,3,1906,933000
6762812076,2160,8,1620,540,3,1917,900000
6762812655,3450,10,3450,0,4,1987,832500
6762812830,3230,9,2350,880,5,2002,815000
6762813645,3050,9,2050,1000,4,1984,750000
6762813726,2110,8,2110,0,4,1966,746000
6762813924,3660,10,3660,0,4,1990,730000
6762814215,2410,8,2410,0,4,1965,711800
6762814306,1970,9,1770,200,3,1980,705000
6762814435,2390,8,2390,0,2,2007,699950
6762815074,2080,7,1040,1040,3,1926,660000
6762815299,1540,8,1230,310,3,2002,650000
6762816067,2330,9,2330,0,3,1998,612000
6762816829,2180,9,2180,0,3,1985,580000
6762816971,2270,8,2270,0,3,1979,575000
6762817222,2520,8,1520,1000,4,1979,565000
6762817275,1580,7,870,710,3,1940,563000
6762818484,830,7,830,0,1,1924,525000
6762819386,1850,7,1850,0,2,1903,495000
6762819557,1580,7,790,790,3,1909,489950
6762819662,3273,8,2671,602,4,2014,485000
6762820200,2620,7,1660,960,3,1976,469000
6762821104,1510,8,1510,0,2,1985,445000
6762821508,1750,7,1330,420,3,1978,435000
6762821917,2200,7,1250,950,4,1959,425000
6762822105,2540,8,1520,1020,5,1980,420000
6762823146,2250,9,2250,0,4,1987,395000
6762824572,2390,7,1270,1120,5,1980,358000
6762824600,1540,7,1140,400,5,1990,357000
6762824687,1240,7,1240,0,3,1962,355000
6762825185,1390,7,1230,160,3,1903,345000
6762826150,1560,7,1210,350,3,1964,324950
6762827211,1320,7,1320,0,3,2005,299950
6762827394,1690,7,1690,0,3,2003,295000
6762829267,1910,7,1290,620,3,1964,250000
6762829268,1800,7,1800,0,4,2000,250000
6762830228,1670,7,1300,370,3,1990,223000
6762830449,1280,7,1280,0,3,1975,215000
6762830656,1130,6,1130,0,2,1952,207000
6762830969,1240,6,1240,0,3,1987,192000
6762831481,1200,8,1200,0,3,1966,140000
6762831581,560,5,560,0,1,1947,106000
6762811635,3130,9,2430,700,4,2011,975000
6762822959,1230,8,1080,150,3,2009,399950
6762819299,3216,9,3216,0,4,2014,498445
6762830110,1520,7,1030,490,3,1954,226000
6762831602,980,6,980,0,3,1969,90000
6762811496,3040,9,3040,0,3,2005,1000000
6762810230,5230,11,4450,780,5,2014,1990000
6762810276,4285,10,4285,0,4,2013,1890000
6762810429,4660,12,4660,0,3,1975,1640000
6762810529,3720,10,3720,0,6,2003,1520000
6762810611,3420,10,3420,0,5,2006,1440000
6762810612,2660,8,1930,730,4,1968,1440000
6762810988,3270,8,2180,1090,4,1909,1210000
6762811051,3960,11,3960,0,4,2001,1190000
6762811233,3830,9,2030,1800,4,1969,1100000
6762811403,4090,11,4090,0,4,1991,1040000
6762811775,5635,10,4360,1275,4,2011,950000
6762811861,3640,9,3640,0,4,2014,932990
6762812009,2640,10,2640,0,5,2009,910000
6762812046,1140,6,1140,0,2,1947,903000
6762812645,2550,9,2550,0,3,1983,834000
6762812701,1740,8,1500,240,3,1948,827235
6762812995,5480,10,5140,340,6,1991,800000
6762813047,3290,10,2220,1070,4,1990,799000
6762813062,2590,10,2590,0,3,1993,796500
6762813324,3520,8,1530,1990,3,1960,775000
6762814194,2920,8,1520,1400,5,1976,713500
6762814885,1220,7,1220,0,3,1954,672000
6762814956,1400,8,1400,0,3,1909,667000
6762815075,1960,7,1960,0,4,1922,660000
6762815196,2160,9,2160,0,4,1989,653000
6762815412,3280,10,3280,0,3,2001,645000
6762815593,2240,7,1120,1120,3,1955,635000
6762815636,2720,10,2720,0,4,1994,632500
6762816013,2220,8,2040,180,3,1975,615000
6762816208,2250,8,2250,0,4,1967,605000
6762816423,3410,8,3410,0,4,1972,599000
6762816972,1840,8,1140,700,2,1957,575000
6762816973,1610,7,1020,590,4,1982,575000
6762817039,1710,7,1710,0,4,1956,571900
6762817364,2020,9,2020,0,3,1976,560000
6762817479,2260,8,1620,640,4,1976,555000
6762817480,1720,7,860,860,4,1940,555000
6762818094,2520,8,2520,0,4,2009,536000
6762818763,910,7,910,0,2,1949,515000
6762818764,2980,9,2980,0,5,2007,515000
6762819156,2220,8,1110,1110,3,1962,500000
6762819157,1900,8,1200,700,4,2008,500000
6762819387,3620,9,3620,0,4,1980,495000
6762819514,1600,8,1600,0,3,1984,490000
6762819804,1160,7,1160,0,3,1959,480000
6762820225,3160,7,1880,1280,4,1969,467500
6762820238,2660,8,1330,1330,3,1948,467000
6762820313,1480,7,1480,0,3,1954,465000
6762820479,1430,7,1430,0,2,1938,460000
6762820480,2690,9,2690,0,4,1986,460000
6762820708,1650,7,1270,380,3,1991,453000
6762820868,2900,7,2040,860,4,1911,450000
6762821148,1130,7,880,250,2,1939,443000
6762821687,1090,7,1090,0,2,1900,430000
6762821810,1680,7,1290,390,3,1969,427000
6762821918,1530,8,1530,0,3,1958,425000
6762822106,1240,7,1240,0,3,1968,420000
6762822670,1370,7,1370,0,2,1987,405000
6762822782,2020,7,1260,760,3,1969,401000
6762822789,1690,6,890,800,4,1946,400375
6762822886,2580,8,2580,0,3,1946,400000
6762823509,1950,7,1150,800,4,1963,385000
6762823915,1370,8,1370,0,3,2007,375000
6762824191,1560,7,1060,500,3,1969,368000
6762824340,1020,6,1020,0,4,1947,364000
6762824527,1850,7,1850,0,3,2010,359782
6762824688,1880,8,1250,630,3,1974,355000
6762824689,2540,7,2540,0,5,2014,355000
6762824929,1010,7,1010,0,3,1967,350000
6762824930,2190,7,2190,0,4,2006,350000
6762825186,1820,6,910,910,2,1948,345000
6762825284,1200,7,1200,0,3,1986,342000
6762825614,980,7,980,0,3,1966,335000
6762825813,950,6,950,0,2,1909,330000
6762826302,1730,7,1730,0,4,1971,320000
6762827148,1810,7,1240,570,3,1977,300000
6762827280,2450,8,2450,0,3,1993,299000
6762827717,1610,7,1610,0,4,2013,286950
6762827858,2770,7,1490,1280,5,1979,283450
6762827978,1190,7,1190,0,2,2005,280000
6762828545,1370,7,1370,0,3,1966,268000
6762828849,1850,7,1250,600,3,1968,260000
6762828924,1400,7,1040,360,3,1985,258900
6762828940,1790,7,1790,0,3,1998,258000
6762829051,930,7,930,0,3,1978,255000
6762829132,1290,7,1290,0,3,1990,253000
6762829269,1060,7,1060,0,3,1960,250000
6762829404,700,6,700,0,2,1950,247500
6762829665,1980,7,1980,0,4,1996,240000
6762830001,1060,7,1060,0,3,1948,230000
6762830060,810,6,810,0,2,1955,229000
6762830171,1700,8,1700,0,4,1994,225000
6762830291,1000,7,990,10,2,2004,220000
6762831135,1960,5,1960,0,3,1908,180000
6762831150,1130,7,1130,0,3,1954,179950
6762831181,1390,7,1390,0,3,2014,175003
6762810867,2870,8,1730,1140,4,1951,1270000
6762811449,2550,7,2550,0,6,1907,1020000
6762811685,4070,10,4070,0,4,1989,965000
6762811795,2980,9,1860,1120,4,1973,949000
6762811915,3540,10,3540,0,4,1996,925000
6762812996,4600,10,4600,0,4,1990,800000
6762813094,1960,8,1330,630,3,1911,792500
6762813239,1660,8,1460,200,3,1911,780000
6762813537,1640,8,1640,0,3,2014,759000
6762813560,2870,8,2870,0,3,1984,755000
6762813899,1960,8,1960,0,3,2010,732000
6762814019,940,7,940,0,3,1952,725000
6762814307,2300,8,2300,0,2,2007,705000
6762814507,1790,8,1790,0,5,1952,695000
6762814997,2280,7,1470,810,4,1926,665000
6762815300,3610,8,3610,0,6,1966,650000
6762815301,1610,8,1610,0,4,1966,650000
6762815807,1860,8,1860,0,3,1993,625000
6762816830,2720,7,1530,1190,5,1939,580000
6762817090,3370,8,1770,1600,6,1964,570000
6762817481,2350,7,1410,940,4,1946,555000
6762817660,1650,7,1650,0,3,1950,550000
6762817738,2720,8,1510,1210,4,1969,549950
6762817855,2500,9,2500,0,4,1997,545000
6762818063,2620,8,1970,650,3,1992,538000
6762818157,1370,7,1020,350,2,1952,535000
6762818360,2160,7,1380,780,3,1987,528000
6762818623,2490,9,2150,340,4,1985,520000
6762818711,2330,9,1300,1030,3,1971,516000
6762818884,2350,7,2350,0,3,1983,510000
6762818974,1060,7,960,100,2,1926,506000
6762818978,1300,8,1300,0,3,2005,505500
6762819996,1460,8,1150,310,3,1988,475000
6762819997,2240,7,1140,1100,4,1972,475000
6762820253,2170,7,1220,950,4,1976,466000
6762820314,1450,8,1030,420,3,1995,465000
6762820869,1150,7,1150,0,3,1917,450000
6762820870,2530,8,2530,0,3,1987,450000
6762820871,950,7,950,0,2,1925,450000
6762821027,2250,7,1360,890,5,1977,446950
6762821134,1460,7,1140,320,3,2003,443750
6762821277,1690,8,1690,0,4,1929,440000
6762821278,2600,8,1810,790,4,1968,440000
6762821432,2495,7,2495,0,4,2002,436000
6762821583,3080,7,3080,0,6,1900,432500
6762821919,1630,7,1630,0,3,1994,425000
6762822107,2100,7,1400,700,2,1908,420000
6762822108,1900,8,1520,380,3,2009,420000
6762822507,2270,8,1420,850,3,1954,410000
6762822508,2650,8,1760,890,3,1956,410000
6762822709,1720,7,1720,0,3,1995,404000
6762822726,720,6,720,0,2,1905,403000
6762822887,1920,7,1920,0,3,1968,400000
6762823009,1460,8,1460,0,3,1959,399000
6762823308,2350,8,2350,0,3,2003,390000
6762823366,2160,7,2160,0,3,2007,389900
6762823414,3190,8,3190,0,4,1979,387500
6762823510,2960,8,2360,600,4,1979,385000
6762823599,1740,7,1740,0,4,1924,382000
6762823675,1260,7,940,320,3,2007,380000
6762823916,1540,8,1540,0,3,2010,375000
6762824101,1250,7,830,420,3,2006,370000
6762824601,1590,7,1080,510,3,1976,357000
6762824690,2370,7,1280,1090,3,1979,355000
6762824768,2130,7,1100,1030,5,1978,353000
6762824931,1820,7,1320,500,4,1952,350000
6762824932,1740,7,1740,0,3,1965,350000
6762824933,830,7,830,0,2,2006,350000
6762825033,1550,6,970,580,2,1969,349900
6762825255,1180,7,940,240,2,1957,343000
6762825369,1900,7,1540,360,3,1969,340000
6762825370,860,6,860,0,2,1947,340000
6762825814,2370,9,2370,0,3,1990,330000
6762826063,1230,7,1160,70,2,2008,325000
6762826303,1460,7,1460,0,4,1955,320000
6762827583,900,7,900,0,2,1998,290000
6762827899,1280,7,1060,220,2,1951,281000
6762827979,1800,8,1800,0,3,1987,280000
6762827980,940,6,940,0,3,1948,280000
6762828432,1930,7,1930,0,5,1966,270000
6762828433,1770,7,1770,0,3,1996,270000
6762828553,1410,8,1410,0,3,2014,267800
6762828850,1710,7,1240,470,3,1976,260000
6762828941,1040,6,1040,0,3,1951,258000
6762829270,1470,6,1470,0,3,2003,250000
6762829364,1752,8,1752,0,3,2005,249000
6762829543,1360,7,1360,0,3,1966,244900
6762829895,1200,6,1200,0,2,2003,234000
6762829908,850,8,850,0,2,2001,233000
6762829912,910,6,910,0,3,1973,232900
6762830002,2140,8,2140,0,6,1903,230000
6762830079,1000,7,1000,0,3,1959,228000
6762830349,970,6,970,0,3,1967,219000
6762830578,1520,6,1520,0,4,1920,210000
6762830579,1440,7,1440,0,3,1963,210000
6762830616,1330,7,1330,0,3,1976,209000
6762831501,1520,6,1120,400,3,1961,135000
6762810091,6410,12,5610,800,4,1906,2730000
6762810187,3540,10,3000,540,4,1940,2200000
6762810351,4870,10,3650,1220,5,1929,1740000
6762810362,4290,9,2480,1810,5,1972,1710000
6762811151,4700,10,2930,1770,5,2006,1140000
6762811563,2780,7,1390,1390,4,1967,990000
6762811934,3670,9,3670,0,4,1994,921500
6762812077,2320,8,1620,700,3,1907,900000
6762812345,3500,8,2430,1070,6,1909,865000
6762812630,1490,8,1490,0,3,1984,835000
6762812699,1810,7,1310,500,3,1960,827500
6762812884,3470,8,2520,950,4,1979,810000
6762813467,2150,8,1400,750,3,1906,762000
6762813831,1520,7,1520,0,3,1936,738000
6762814095,2180,8,1090,1090,3,1941,720000
6762814383,2672,8,2020,652,4,2005,700000
6762814830,2920,9,2920,0,4,2004,675000
6762814910,3340,8,3340,0,3,1950,670000
6762815206,2230,8,1630,600,3,1974,652450
6762815914,2040,8,1740,300,3,1930,620000
6762816259,1470,7,970,500,2,1941,602000
6762816265,1660,7,1120,540,2,1906,601150
6762816580,3360,8,3360,0,3,1989,590000
6762816974,2690,8,2690,0,3,1992,575000
6762817365,2410,7,1600,810,5,1978,560000
6762817661,1540,8,1540,0,3,2008,550000
6762818485,1580,8,1160,420,4,1973,525000
6762818578,2100,9,2100,0,3,1997,521900
6762818624,2510,8,2510,0,3,1981,520000
6762818765,2800,8,2800,0,4,2003,515000
6762818766,1300,8,1300,0,3,2008,515000
6762819065,1810,8,1170,640,2,1962,501000
6762819158,1490,8,1220,270,3,2001,500000
6762819159,1800,7,1300,500,3,1972,500000
6762819334,1420,7,1420,0,2,1941,496000
6762819741,950,7,950,0,2,1941,482000
6762820045,1850,9,1850,0,3,2013,474950
6762820057,1090,7,840,250,2,1926,474000
6762820103,1760,7,1070,690,4,1962,471000
6762820647,2811,9,2811,0,4,2009,455000
6762821105,2690,8,2690,0,3,1994,445000
6762821279,1650,8,1650,0,3,1977,440000
6762821400,990,7,790,200,2,1907,437500
6762821509,1990,8,1990,0,4,1973,435000
6762821688,1830,8,1400,430,3,1976,430000
6762822426,2210,8,2210,0,3,1985,412000
6762822557,1440,8,1440,0,3,1972,409000
6762822888,2470,8,1250,1220,5,1977,400000
6762822960,2150,8,1450,700,4,1969,399950
6762823227,2600,8,2600,0,4,1991,392000
6762823785,2140,7,1190,950,4,1959,378000
6762823917,1720,7,970,750,4,1930,375000
6762823918,1050,8,960,90,2,2007,375000
6762824242,1140,6,1140,0,2,1909,365500
6762824545,2180,7,2180,0,4,1950,359000
6762824691,530,4,530,0,1,1950,355000
6762824934,1570,7,1570,0,4,1972,350000
6762825121,1060,7,730,330,3,2006,346000
6762825187,1770,8,1220,550,2,1957,345000
6762825371,1280,8,1030,250,3,1976,340000
6762825815,1750,6,1070,680,4,1942,330000
6762826064,1050,7,1050,0,3,1951,325000
6762826065,1570,8,1570,0,3,1999,325000
6762826205,2060,7,1280,780,4,1981,322500
6762826529,1900,7,1130,770,3,1977,315000
6762827516,1580,7,1580,0,4,1984,291000
6762827800,1990,7,1090,900,3,1961,285000
6762828365,1490,7,1090,400,3,1976,271500
6762828782,2040,7,1190,850,4,1961,261000
6762828851,1740,7,1020,720,4,1962,260000
6762829271,1830,8,1830,0,4,2001,250000
6762829421,1640,8,1180,460,3,1968,247000
6762829449,1260,7,1260,0,2,1957,245560
6762829666,1460,7,1140,320,3,1986,240000
6762829667,1890,7,1190,700,3,1959,240000
6762830095,1340,7,1340,0,3,1959,227000
6762830172,1740,7,1740,0,3,1989,225000
6762830617,1320,6,1320,0,3,1912,209000
6762831040,710,6,710,0,2,1926,187250
6762831136,1460,6,1290,170,5,1936,180000
6762810868,3950,9,2250,1700,5,1953,1270000
6762810908,3710,9,2340,1370,5,1977,1250000
6762811281,3000,8,1550,1450,4,1969,1080000
6762811648,4010,11,4010,0,4,2003,972000
6762812265,1820,7,1820,0,3,1953,875000
6762812631,4030,8,3310,720,4,1943,835000
6762813646,2020,7,1010,1010,5,1963,750000
6762813740,2970,9,1770,1200,3,1995,745000
6762814131,2090,8,1890,200,3,1931,717500
6762814998,1615,8,1615,0,2,1906,665000
6762815076,960,6,960,0,2,1942,660000
6762815736,2280,8,2280,0,4,1987,626100
6762815866,2280,7,1510,770,4,1942,622100
6762816487,1510,7,1010,500,2,1900,595000
6762817366,1810,8,1810,0,4,1926,560000
6762817662,3540,10,3540,0,4,2003,550000
6762818064,2000,7,1250,750,3,1960,538000
6762818332,1240,8,1240,0,3,2014,529950
6762818361,2940,8,1700,1240,5,1977,528000
6762818376,2270,8,1310,960,4,1973,527500
6762818885,2060,8,1100,960,3,1982,510000
6762819515,2800,8,1880,920,8,1997,490000
6762820563,1390,9,1150,240,3,2006,458000
6762820590,1750,7,1150,600,3,1962,456150
6762820872,1850,7,1100,750,4,1956,450000
6762821324,1230,8,1010,220,3,2003,439950
6762821758,2160,8,2160,0,4,1977,429000
6762821793,1900,7,1300,600,3,1971,427500
6762821920,1490,7,1110,380,4,1977,425000
6762822109,1720,8,1720,0,3,1932,420000
6762822151,1830,7,1330,500,3,1968,419995
6762822671,1450,7,1450,0,3,1969,405000
6762822889,2070,7,2070,0,4,1982,400000
6762823309,1050,8,960,90,2,2007,390000
6762823511,2020,7,2020,0,5,1950,385000
6762823512,2630,7,2630,0,4,2010,385000
6762824935,1320,7,1320,0,2,1993,350000
6762824936,790,6,790,0,1,1911,350000
6762825256,1040,6,1040,0,2,1953,343000
6762825372,2690,9,2690,0,4,1998,340000
6762825991,1400,7,1000,400,4,1954,325088
6762826304,1330,7,1330,0,3,1971,320000
6762826530,1480,7,1480,0,3,1968,315000
6762826735,1930,8,1930,0,4,1994,310000
6762826786,2100,7,1400,700,5,1974,309900
6762826872,1250,7,1250,0,3,1959,306000
6762827395,1000,6,1000,0,3,1951,295000
6762827431,1760,7,1760,0,3,2005,294500
6762827490,2060,8,2060,0,4,2000,292000
6762827584,1040,7,1040,0,3,1955,290000
6762827981,1430,7,1430,0,3,1993,280000
6762828116,2550,8,1750,800,4,1976,277500
6762828303,1360,6,1020,340,4,1944,273500
6762828529,2200,7,1100,1100,5,1963,268450
6762828660,2040,8,2040,0,4,2001,265000
6762828661,1080,6,1080,0,3,1950,265000
6762829052,1020,7,1020,0,3,1959,255000
6762829272,1660,7,1010,650,3,1985,250000
6762829391,700,6,700,0,2,1953,248000
6762829668,1600,7,1600,0,3,1971,240000
6762829771,1290,7,1290,0,3,1998,237000
6762830607,1660,7,960,700,3,1963,209950
6762830707,1420,7,820,600,3,1980,205000
6762830858,1160,7,1160,0,3,1977,199500
6762831351,1200,6,1200,0,3,1948,160000
6762831455,1010,7,1010,0,3,1969,147500
6762810105,5540,11,4280,1260,4,2006,2580000
6762810254,3950,11,2880,1070,3,1998,1930000
6762810633,3580,9,3580,0,5,1966,1410000
6762810957,3180,11,3180,0,4,1986,1230000
6762811066,4060,10,4060,0,4,1991,1180000
6762813240,2206,6,866,1340,3,1983,780000
6762813757,3410,9,3410,0,4,2012,743000
6762814527,2820,10,2820,0,4,1991,692500
6762814539,3130,8,3130,0,4,2014,690500
6762814574,2740,9,2740,0,4,1999,690000
6762814831,2070,8,1490,580,3,1966,675000
6762814832,2760,9,2760,0,4,1976,675000
6762815077,2030,7,2030,0,3,1963,660000
6762815808,2140,7,1190,950,4,1951,625000
6762816581,1970,8,1680,290,3,2007,590000
6762816665,2230,8,1430,800,3,1975,585188
6762816704,3050,8,2240,810,3,1990,585000
6762816870,1760,7,880,880,2,1946,579000
6762817162,1350,7,1070,280,2,1939,567500
6762817223,2560,8,1590,970,5,2012,565000
6762817400,2150,8,2150,0,3,1984,559500
6762817663,3070,9,1720,1350,3,1985,550000
6762818348,2380,8,1580,800,5,1976,529000
6762818767,2130,8,2130,0,3,1986,515000
6762818886,1470,8,1340,130,2,2005,510000
6762819160,680,6,680,0,2,1922,500000
6762819341,2710,7,1410,1300,5,1955,495200
6762819663,2060,7,1030,1030,2,1929,485000
6762820372,730,7,730,0,2,1929,464000
6762820873,1790,7,1400,390,2,2001,450000
6762820874,1990,7,1030,960,4,1965,450000
6762821380,1990,7,1990,0,5,1974,438000
6762821689,2500,8,1430,1070,5,1999,430000
6762821921,1390,7,1390,0,4,1908,425000
6762822672,2020,7,2020,0,3,1965,405000
6762822890,1860,6,1300,560,3,1918,400000
6762823310,1550,8,1280,270,3,2001,390000
6762824021,1780,7,1780,0,4,1962,372000
6762824167,2370,9,2370,0,4,1998,369000
6762824352,2250,8,2250,0,4,1986,363000
6762824461,1750,7,1220,530,4,1977,360000
6762824573,890,7,890,0,3,1960,358000
6762824602,2700,9,2700,0,4,1988,357000
6762824609,1570,7,1170,400,4,1959,356500
6762825373,2380,8,2380,0,4,1995,340000
6762825486,1790,6,1790,0,4,1951,338000
6762825816,2980,8,2980,0,4,2003,330000
6762825939,1550,8,1550,0,2,2008,328000
6762826066,2550,7,2550,0,3,2006,325000
6762826177,1160,7,1160,0,3,1957,324000
6762826305,1070,6,1070,0,2,1930,320000
6762827242,1280,6,1280,0,3,1958,299500
6762827281,1510,7,1510,0,3,1974,299000
6762827432,1400,7,1300,100,4,1961,294450
6762828434,1800,6,1470,330,3,1984,270000
6762829697,1740,7,1140,600,3,1967,239999
6762829923,1280,7,1280,0,3,1994,232000
6762830450,1480,7,1120,360,2,1925,215000
6762831027,1200,7,1200,0,2,1921,189000
6762831561,1000,5,1000,0,2,1913,115000
6762813505,1780,8,1400,380,3,1927,760000
6762816014,2710,8,1650,1060,3,2005,615000
6762821690,2160,7,1580,580,3,1987,430000
6762826306,1140,6,1140,0,2,1911,320000
6762826384,2390,8,2390,0,4,1990,319000
6762827801,720,6,720,0,2,1943,285000
6762812554,3560,11,3560,0,3,1997,843500
6762817773,1540,8,1540,0,3,2014,549000
6762810101,5540,11,3950,1590,6,1909,2630000
6762810195,4750,11,4750,0,4,1976,2180000
6762810776,2860,8,2860,0,4,1953,1320000
6762810933,5120,10,3290,1830,4,2008,1240000
6762811471,3510,9,3510,0,5,2013,1010000
6762811569,3320,8,1660,1660,5,1963,989900
6762812010,3750,9,3750,0,5,2001,910000
6762812357,3190,10,3190,0,4,1999,864000
6762812446,3200,8,2000,1200,3,1977,851500
6762812524,2450,8,1770,680,5,1951,849000
6762812788,3540,10,3540,0,4,1998,820000
6762812997,2390,9,1590,800,4,1975,800000
6762812998,1890,8,1890,0,3,1969,800000
6762813506,3920,7,2560,1360,5,1910,760000
6762813647,3290,9,3290,0,4,2004,750000
6762813925,3800,9,3800,0,4,2008,730000
6762813971,2180,8,2180,0,4,1999,726500
6762814068,2120,7,1420,700,4,1926,720168
6762814273,3060,8,3060,0,5,2004,708000
6762814474,3220,9,3220,0,4,2004,697000
6762814508,2360,8,1520,840,4,2001,695000
6762814911,3860,8,2660,1200,5,1973,670000
6762815111,2350,8,2350,0,4,1977,659000
6762815302,2800,7,1400,1400,3,1954,650000
6762815303,1430,7,1430,0,3,1924,650000
6762815413,2930,9,2930,0,3,1983,645000
6762815969,3020,8,3020,0,3,1992,617000
6762816078,1850,7,1850,0,3,1922,611000
6762816338,2680,9,2680,0,3,1986,600000
6762816339,2120,7,1060,1060,2,1923,600000
6762816705,2290,9,2290,0,3,2001,585000
6762817552,2950,9,2950,0,4,2006,551500
6762817664,2850,9,2850,0,4,2003,550000
6762818349,2800,7,2800,0,4,1934,529000
6762818560,3000,8,1900,1100,3,1963,523000
6762818941,2520,8,1720,800,4,1979,508500
6762819161,2210,7,1030,1180,3,1912,500000
6762819434,1600,7,1600,0,2,1978,492500
6762819516,2020,7,2020,0,4,1995,490000
6762819998,1470,7,1470,0,3,1963,475000
6762819999,2680,7,1340,1340,3,1989,475000
6762820315,1810,7,1810,0,4,1961,465000
6762820316,1390,7,1340,50,2,2009,465000
6762820520,2250,8,1460,790,3,1976,459900
6762820551,1330,7,970,360,4,1957,458450
6762821280,3690,9,1890,1800,5,1985,440000
6762822561,2720,9,2720,0,4,2003,408500
6762822673,800,6,800,0,2,1942,405000
6762822891,880,6,880,0,2,1931,400000
6762822961,1470,7,1470,0,3,1980,399950
6762823311,1000,7,1000,0,3,1956,390000
6762824102,1580,7,1180,400,3,1976,370000
6762824192,2720,9,2720,0,4,1989,368000
6762824462,1920,7,1080,840,4,1962,360000
6762824692,2590,8,2590,0,4,2001,355000
6762825968,1860,7,1860,0,3,2000,326995
6762826531,1480,8,1180,300,3,2013,315000
6762826644,1190,6,1190,0,4,1926,312000
6762826736,1210,7,1210,0,3,1956,310000
6762827491,1320,7,1320,0,3,1988,292000
6762827492,1984,7,1984,0,4,2012,292000
6762827585,1340,7,1340,0,2,1949,290000
6762827705,2660,7,2660,0,4,2010,287000
6762828098,1420,7,1420,0,2,2004,278000
6762828923,1440,8,1440,0,3,1985,258950
6762829544,620,5,620,0,1,1939,244900
6762829746,1650,7,910,740,4,1978,238000
6762830173,1430,7,1430,0,3,1968,225000
6762830174,1100,6,1100,0,3,1969,225000
6762830632,960,7,960,0,2,1951,208000
6762831076,1240,7,1240,0,3,1959,185000
6762831137,780,6,780,0,3,1920,180000
6762831219,730,6,730,0,2,1950,174950
6762831585,1170,6,1170,0,2,1949,104950
6762810089,4130,10,2860,1270,4,1993,2750000
6762810193,3360,10,2770,590,3,1905,2190000
6762810316,4320,8,4320,0,5,1938,1800000
6762810459,4060,10,4060,0,4,2005,1600000
6762810654,4290,11,2690,1600,4,1997,1400000
6762810690,5150,10,3700,1450,5,2007,1380000
6762810815,3700,8,2750,950,5,1950,1300000
6762810855,2720,9,1870,850,4,1963,1280000
6762811131,2840,8,2240,600,4,1972,1150000
6762811636,2420,8,2420,0,4,1925,975000
6762811983,2580,7,1730,850,5,1954,915000
6762812396,3180,9,3180,0,6,2014,859950
6762813080,2830,10,2830,0,2,2001,795000
6762813126,3040,10,3040,0,3,1983,790000
6762813575,3060,9,3060,0,4,2005,753000
6762813976,3070,10,3070,0,4,2000,725786
6762814455,2440,9,1660,780,4,1970,699000
6762814649,2770,8,2120,650,6,1921,685000
6762814720,2980,10,2980,0,4,1990,680000
6762814759,2610,7,1750,860,5,1909,678940
6762814833,2670,8,1630,1040,4,1908,675000
6762815622,3280,7,3280,0,4,2005,634800
6762816239,1960,7,1050,910,4,1965,604000
6762816340,2520,8,1680,840,4,1968,600000
6762816447,2030,8,1600,430,3,1981,597500
6762816533,1170,7,800,370,3,1947,592500
6762816606,1670,9,1350,320,3,2014,589950
6762817224,1960,9,1960,0,4,1983,565000
6762817415,2220,8,1280,940,3,1982,558000
6762818065,2570,7,2170,400,3,1951,538000
6762818158,1850,9,1790,60,3,2005,535000
6762818486,1290,8,1000,290,3,2006,525000
6762819337,1710,7,1710,0,4,1924,495800
6762819517,1870,7,1090,780,4,1962,490000
6762819805,2240,7,1390,850,5,1952,480000
6762820156,1220,6,1220,0,2,1908,470000
6762820157,900,7,900,0,2,1947,470000
6762820317,2870,10,2870,0,3,1988,465000
6762820586,2000,8,2000,0,4,2008,456500
6762820875,2120,8,2120,0,4,1996,450000
6762821106,1410,7,1110,300,3,1954,445000
6762821433,1770,7,1350,420,3,1976,436000
6762822035,1320,7,920,400,2,1938,422000
6762822225,2680,8,2680,0,3,1970,417400
6762822674,2800,7,1400,1400,6,1954,405000
6762823022,2820,9,2820,0,4,2007,398500
6762824200,2140,7,1280,860,5,1978,367777
6762824353,1120,7,770,350,2,1926,363000
6762824394,1150,7,1150,0,3,1964,361000
6762824530,2390,9,2390,0,4,1988,359500
6762824693,1410,7,1290,120,3,2004,355000
6762825061,1870,7,1480,390,4,1972,348500
6762825188,1690,7,1690,0,3,1979,345000
6762825374,1100,7,1100,0,2,1997,340000
6762825487,1690,8,1410,280,3,2014,338000
6762825513,1400,7,700,700,3,1919,337000
6762825817,2440,8,2440,0,4,1983,330000
6762826189,1910,8,1910,0,3,2004,323000
6762826873,1200,7,800,400,2,1956,306000
6762827675,2790,7,2140,650,5,1949,288000
6762827867,2100,7,1200,900,4,1959,283000
6762828070,2009,8,2009,0,4,2012,279000
6762828146,1480,7,740,740,2,1919,276000
6762828230,1690,7,1690,0,4,1957,275000
6762828497,1700,7,1700,0,4,1999,269500
6762828594,1805,7,1805,0,3,2009,266000
6762828768,1880,7,1880,0,3,2010,261950
6762828969,770,7,770,0,2,1951,257000
6762829053,1340,7,1340,0,3,1920,255000
6762829173,1790,7,1790,0,4,1996,251100
6762829505,1850,7,1850,0,4,1960,245000
6762830175,1310,7,1310,0,3,1969,225000
6762830215,1100,7,1100,0,3,1969,224000
6762830292,1650,7,1650,0,3,1959,220000
6762830324,1210,6,1210,0,3,1954,219950
6762830451,1100,7,1100,0,3,1967,215000
6762830966,1100,7,1100,0,3,1966,192500
6762831226,990,7,990,0,3,1936,173250
6762810051,6840,11,4350,2490,2,2001,3280000
6762810571,3680,10,3680,0,5,1927,1480000
6762811282,2990,8,2090,900,4,1923,1080000
6762811326,4140,11,4140,0,4,2005,1060000
6762811776,2150,8,1140,1010,3,1960,950000
6762811883,4150,10,4150,0,5,2013,929000
6762812632,2960,10,2960,0,3,2009,835000
6762812643,2760,10,2760,0,3,2014,834538
6762812696,3400,9,3400,0,4,2001,828200
6762813325,3820,9,3820,0,3,1987,775000
6762813507,2040,8,1480,560,4,1958,760000
6762813792,2020,9,2020,0,3,1961,740000
6762813884,2120,8,2120,0,3,1904,733500
6762814020,2870,9,2870,0,4,2006,725000
6762814523,3160,10,3160,0,4,1999,693000
6762814650,3320,9,3320,0,4,1997,685000
6762814894,1790,8,1790,0,3,2007,670950
6762815041,1940,8,1940,0,3,1991,661000
6762815304,2150,8,1590,560,3,1959,650000
6762815915,2580,8,2580,0,4,1993,620000
6762816488,2400,8,1400,1000,3,1962,595000
6762816913,1640,7,1180,460,3,1967,575950
6762817025,1590,7,1290,300,3,1926,572500
6762817665,1130,7,880,250,3,1947,550000
6762817928,2060,8,1010,1050,3,1977,541338
6762818159,2670,9,2670,0,3,2000,535000
6762818196,2490,8,1720,770,3,2005,533500
6762818296,2640,8,1550,1090,3,1978,530000
6762819162,1800,7,1020,780,3,1964,500000
6762819518,1510,7,1220,290,3,1967,490000
6762820201,1440,7,1440,0,3,2014,469000
6762820318,1830,7,1030,800,5,1955,465000
6762820876,1620,8,1540,80,3,2012,450000
6762821363,2740,9,2740,0,4,2006,438900
6762822335,3000,8,3000,0,1,1979,415000
6762822544,1790,7,1270,520,5,1961,409950
6762822937,1690,7,970,720,5,1943,399990
6762823513,2030,7,1330,700,4,1969,385000
6762823618,1770,8,1770,0,3,1959,381000
6762823801,1680,8,1150,530,3,1979,377000
6762823919,2200,8,1570,630,3,1977,375000
6762824290,2420,8,2420,0,4,2013,365000
6762824463,2750,9,2750,0,4,2002,360000
6762824464,2000,8,2000,0,4,2003,360000
6762824603,2750,8,2750,0,5,1987,357000
6762824694,1240,7,1060,180,3,1940,355000
6762824695,1960,8,1600,360,3,1980,355000
6762825124,1340,8,1340,0,5,1934,345950
6762825189,1550,7,1550,0,4,1957,345000
6762825899,1820,7,1820,0,4,1994,329500
6762826067,2650,7,2650,0,6,1977,325000
6762826178,1920,8,1920,0,3,1999,324000
6762826532,1010,7,1010,0,3,1977,315000
6762827149,1020,7,720,300,3,2004,300000
6762827282,1040,7,1040,0,3,1969,299000
6762827523,2510,9,2510,0,4,2003,290500
6762827913,920,6,490,430,2,1949,280300
6762828099,1850,7,1850,0,4,1991,278000
6762828147,2495,8,2495,0,3,2007,276000
6762828231,1290,7,950,340,2,1956,275000
6762828595,1860,8,1140,720,4,1978,266000
6762828705,1400,7,1400,0,3,1964,264950
6762828970,1400,7,1400,0,4,1975,257000
6762829184,2140,8,2140,0,5,1951,250750
6762829506,1720,7,1140,580,3,1981,245000
6762829507,2020,8,2020,0,4,1969,245000
6762829554,1350,7,1350,0,3,1998,244000
6762829566,1610,7,1610,0,4,1979,243500
6762829843,1980,7,1980,0,3,1959,235000
6762830384,1690,7,1210,480,3,1977,217000
6762830452,1322,7,1322,0,3,2009,215000
6762830760,1010,7,1010,0,3,1969,202000
6762831178,1540,7,1180,360,3,1989,176000
6762831352,1060,6,1060,0,3,1927,160000
6762831537,1230,6,1230,0,3,1916,125000
6762810317,2880,9,1660,1220,5,1959,1800000
6762810655,3700,9,2900,800,5,1983,1400000
6762811169,2520,8,1670,850,4,1925,1130000
6762811200,3520,9,2010,1510,4,1978,1110000
6762811429,2680,9,1870,810,5,1910,1030000
6762811878,6050,9,4150,1900,4,2009,930000
6762812144,3090,10,3090,0,3,1991,891500
6762812676,1840,8,1220,620,3,1959,830000
6762813561,2000,8,2000,0,3,2005,755000
6762813584,1650,7,1650,0,4,1903,752000
6762813926,2030,8,1730,300,4,1921,730000
6762814021,2620,10,2620,0,3,1985,725000
6762814384,3030,8,3030,0,3,1971,700000
6762814385,1950,7,1150,800,4,1957,700000
6762814651,2770,10,2770,0,4,1987,685000
6762814781,2680,9,2680,0,3,1989,676000
6762814782,2240,7,2240,0,3,1995,676000
6762814912,1600,7,990,610,3,1946,670000
6762814999,1650,8,1300,350,3,1953,665000
6762815078,1770,8,1770,0,3,1999,660000
6762815186,2570,7,1320,1250,3,1961,654000
6762815305,3700,9,3700,0,4,2007,650000
6762815501,1470,7,1470,0,3,1926,640000
6762816150,1720,9,1240,480,3,2011,608000
6762816534,1340,8,1340,0,2,1941,592500
6762816658,3190,9,3190,0,4,2006,587000
6762816706,1830,7,1070,760,2,1949,585000
6762816707,2160,8,1830,330,3,2010,585000
6762817225,2730,8,2730,0,4,2003,565000
6762817226,2560,8,1510,1050,3,1958,565000
6762817739,3090,8,2190,900,4,1991,549950
6762817856,1660,8,1660,0,2,2005,545000
6762818487,1480,8,1480,0,2,1974,525000
6762818887,820,5,820,0,2,1949,510000
6762819519,2070,8,1220,850,3,1981,490000
6762819664,2560,7,1500,1060,4,1968,485000
6762819905,1670,7,1390,280,4,1953,476500
6762820254,1680,7,1680,0,3,1959,466000
6762820481,1390,6,790,600,2,1916,460000
6762820960,2520,9,2520,0,3,1988,449888
6762821691,2020,8,1200,820,4,1925,430000
6762821692,4300,8,2800,1500,8,1979,430000
6762821759,1350,7,1350,0,4,1912,429000
6762822892,1890,7,1090,800,3,1967,400000
6762822962,1860,8,1710,150,3,2009,399950
6762823147,870,7,870,0,2,1923,395000
6762823802,1000,7,930,70,2,2006,377000
6762823920,1330,7,1330,0,3,1985,375000
6762824022,2070,8,2070,0,4,1999,372000
6762824103,2531,8,2531,0,4,2013,370000
6762824177,2530,7,1520,1010,5,1992,368500
6762824604,1340,7,1340,0,3,1950,357000
6762824739,1130,7,1130,0,3,1965,354000
6762825225,1330,7,1330,0,3,1985,344950
6762825615,1070,7,1070,0,2,1951,335000
6762825913,1190,7,1190,0,4,1946,329000
6762826307,1480,8,1180,300,3,2013,320000
6762826737,1880,8,1880,0,3,1988,310000
6762826939,1150,7,1150,0,3,1922,305000
6762827150,2400,8,2400,0,4,1992,300000
6762827151,2000,7,1400,600,3,1979,300000
6762827212,1980,7,1480,500,3,1968,299950
6762827706,2410,7,1550,860,2,1978,287000
6762827982,1200,7,1200,0,3,1954,280000
6762828232,1260,7,1260,0,3,2009,275000
6762828233,1620,7,1620,0,3,1989,275000
6762828602,1460,6,1460,0,3,1982,265800
6762828916,1580,7,1580,0,4,1979,259000
6762829105,2070,7,1450,620,3,1969,254000
6762829508,2010,7,1890,120,4,1921,245000
6762830176,1750,7,1050,700,4,1974,225000
6762830204,1630,7,1630,0,3,1963,224950
6762830708,1080,5,1080,0,3,1948,205000
6762831138,1384,6,1384,0,3,1965,180000
6762831151,1200,6,1200,0,2,1958,179950
6762831236,1340,7,1340,0,3,1968,172000
6762831451,1700,7,1700,0,4,1967,148900
6762810071,7400,13,6290,1110,5,2001,2980000
6762810547,3860,9,2870,990,4,2005,1500000
6762810676,4240,10,3500,740,3,1994,1390000
6762810909,2960,10,2960,0,4,1985,1250000
6762810989,4420,11,3510,910,5,2000,1210000
6762811829,3640,9,3640,0,4,2014,939000
6762812364,3220,9,2180,1040,4,1937,862500
6762812613,2450,9,2030,420,4,1980,836000
6762813438,2760,8,2000,760,4,1926,765000
6762813439,2910,10,2910,0,4,1990,765000
6762813508,2350,7,1340,1010,3,1940,760000
6762814436,2190,8,2190,0,3,1983,699950
6762814595,4490,9,3390,1100,4,2006,689000
6762815102,3010,9,3010,0,5,2008,659950
6762815414,2340,9,2340,0,4,1990,645000
6762816341,1700,8,1700,0,4,1975,600000
6762816708,2430,8,2430,0,4,1999,585000
6762817902,940,8,940,0,2,1918,543000
6762818888,2400,8,1540,860,3,1964,510000
6762819163,3000,8,3000,0,4,1975,500000
6762819665,2820,7,1410,1410,4,1958,485000
6762819845,1360,8,1360,0,2,2008,479950
6762820000,2020,7,1180,840,3,1981,475000
6762820001,1600,8,1600,0,3,1953,475000
6762820482,4190,7,4190,0,4,2004,460000
6762820564,3280,7,3280,0,4,1979,458000
6762820758,1680,7,1330,350,4,1966,451000
6762821351,1830,7,1170,660,3,1981,439000
6762821434,2080,8,1240,840,4,1979,436000
6762821760,2650,9,2650,0,4,2001,429000
6762821816,2080,7,1600,480,3,1968,426700
6762821922,1040,7,940,100,2,1928,425000
6762821923,1280,8,1020,260,2,1951,425000
6762822110,1780,7,1030,750,3,1958,420000
6762822111,2390,8,1970,420,3,2006,420000
6762822336,1490,7,1090,400,3,1974,415000
6762822509,2430,8,2430,0,4,2003,410000
6762822765,2770,7,1700,1070,5,1965,402000
6762822893,1510,7,1510,0,3,1968,400000
6762822980,2370,7,1570,800,4,1948,399888
6762823514,1790,7,1100,690,4,2000,385000
6762823515,1560,6,780,780,3,1944,385000
6762824040,1610,7,1610,0,4,1968,371000
6762824291,2905,9,2905,0,4,2003,365000
6762824465,2880,8,1680,1200,5,1976,360000
6762824610,2570,8,2570,0,4,2008,356500
6762825375,1450,7,1450,0,3,1950,340000
6762825818,1676,7,1676,0,3,1997,330000
6762826068,1890,7,1890,0,3,1966,325000
6762826216,1750,7,1750,0,4,1942,322000
6762826533,860,7,860,0,2,1948,315000
6762826622,2300,8,2300,0,4,1996,312500
6762826940,1780,7,870,910,4,1993,305000
6762827008,2056,7,2056,0,3,2014,303000
6762827050,1840,7,1220,620,3,1968,301000
6762827627,2090,7,1050,1040,4,1970,289950
6762827707,720,6,720,0,2,1942,287000
6762827742,710,6,710,0,2,1942,285950
6762828100,1480,7,1480,0,4,1943,278000
6762828662,1630,7,1630,0,3,1991,265000
6762829365,1090,6,1090,0,3,1950,249000
6762830293,1760,6,1760,0,5,1925,220000
6762831139,1010,6,1010,0,3,1990,180000
6762831140,960,5,960,0,2,1946,180000
6762831257,1300,7,1300,0,2,1961,170000
6762831333,1220,7,1220,0,3,1961,161500
6762831473,1090,6,1090,0,3,1969,143000
6762831596,800,7,800,0,2,1947,95000
6762810479,5830,11,5830,0,4,2005,1580000
6762811183,4750,11,4750,0,4,1988,1120000
6762822510,1640,7,1110,530,3,1969,410000
6762826308,1610,8,1240,370,3,2007,320000
6762820877,1860,7,1080,780,4,1953,450000
6762824574,1140,7,1140,0,2,1948,358000
6762825442,1040,7,1040,0,3,1969,339888
6762829577,2060,8,2060,0,4,1995,242550
6762810856,4340,10,2850,1490,4,2008,1280000
6762810910,2070,9,2070,0,3,1930,1250000
6762810911,3370,9,3370,0,5,2005,1250000
6762811497,1880,8,1880,0,3,1924,1000000
6762811579,2160,8,2160,0,3,1951,987000
6762811586,2600,8,2600,0,3,1969,985000
6762811637,3020,9,2020,1000,4,1921,975000
6762811808,3570,9,3570,0,4,2014,942990
6762811862,4690,10,3450,1240,5,1995,932808
6762812078,3860,10,3860,0,4,2014,900000
6762812317,3140,9,3140,0,4,2013,869950
6762812441,3830,10,3830,0,5,2005,852500
6762812496,2700,9,2700,0,2,2012,850000
6762813713,3220,10,3220,0,4,2004,748000
6762813793,2300,8,1600,700,4,1961,740000
6762813882,2530,7,1690,840,4,1925,734000
6762813927,1860,7,1010,850,2,1920,730000
6762813928,2870,9,2870,0,5,2006,730000
6762814173,2410,9,2410,0,3,1989,715000
6762814252,3060,9,3060,0,4,2006,710000
6762814308,3000,9,3000,0,4,2004,705000
6762814481,2900,8,2300,600,6,1977,696000
6762814524,2120,9,1420,700,3,1973,693000
6762814683,2820,9,2820,0,4,2001,682000
6762814721,2060,8,1900,160,3,2001,680000
6762814834,1300,8,1100,200,3,2014,675000
6762815809,2410,7,1220,1190,4,1924,625000
6762816424,2460,8,1330,1130,5,1976,599000
6762817666,1520,7,1170,350,3,1953,550000
6762818160,1520,7,830,690,2,1927,535000
6762818699,1740,7,1740,0,3,1976,517000
6762819164,1680,7,1680,0,3,1962,500000
6762819245,1360,7,730,630,3,1986,499950
6762819281,1450,7,1450,0,2,1919,499000
6762820182,2720,8,1650,1070,4,2008,469950
6762820538,1170,6,1020,150,2,1929,459000
6762820648,2120,7,1060,1060,4,1968,455000
6762821510,2030,8,1630,400,3,1976,435000
6762821693,1740,8,1740,0,3,1952,430000
6762821728,1740,8,1740,0,4,1967,429950
6762821924,1950,8,1950,0,4,2012,425000
6762821995,1830,7,1080,750,4,1967,424500
6762822238,1590,8,1590,0,3,1979,417000
6762822675,1980,7,1980,0,4,2007,405000
6762822719,2400,7,1200,1200,4,1974,403500
6762823409,2520,7,2040,480,4,1954,387846
6762823516,1760,8,1130,630,2,1988,385000
6762823724,870,7,870,0,2,1947,379950
6762824104,3230,9,3230,0,3,1987,370000
6762824292,1200,7,1200,0,2,1929,365000
6762824325,2520,7,1850,670,3,2003,364950
6762824622,1230,8,1230,0,2,2007,356000
6762824769,1830,7,1830,0,4,2002,353000
6762825099,1560,8,1270,290,2,2006,347000
6762825190,2730,7,1390,1340,3,1975,345000
6762825819,1440,7,1440,0,3,1997,330000
6762825950,2090,8,2090,0,3,1991,327500
6762826069,1600,7,1600,0,3,1966,325000
6762826070,2330,6,1430,900,3,1900,325000
6762826349,2120,7,2120,0,4,2003,319990
6762826534,970,6,970,0,3,1928,315000
6762826623,1480,8,1180,300,3,2013,312500
6762827493,2270,7,1370,900,3,1948,292000
6762827586,1200,6,1200,0,2,1948,290000
6762827587,950,6,950,0,2,1943,290000
6762827634,1899,7,1899,0,3,1943,289900
6762827887,1660,7,960,700,4,1956,282000
6762828479,2390,7,2390,0,4,1944,269950
6762828978,1070,9,720,350,2,2008,256950
6762829054,1320,7,1320,0,3,1956,255000
6762829145,1150,7,1150,0,3,1956,252500
6762829273,1700,8,1700,0,3,1997,250000
6762829274,2210,7,2210,0,3,1934,250000
6762829595,1750,7,1750,0,4,1975,242000
6762830294,1440,7,1440,0,4,1959,220000
6762830848,870,6,870,0,2,1946,199950
6762830930,1070,7,1070,0,3,1967,195000
6762830973,990,7,990,0,3,1953,191000
6762831541,1080,5,1080,0,3,1950,124000
6762810102,5270,11,3400,1870,4,1979,2600000
6762810268,5080,11,5080,0,4,2001,1900000
6762810548,2930,9,2310,620,4,1964,1500000
6762811306,2920,9,2260,660,5,2014,1070000
6762811368,4160,10,4160,0,4,1995,1050000
6762811472,4050,12,4050,0,5,1990,1010000
6762811529,2910,9,2910,0,4,1988,998000
6762811543,5610,11,4090,1520,5,1996,995000
6762811879,1800,7,1000,800,2,1942,930000
6762812220,3860,9,1930,1930,3,1970,880000
6762812497,2820,8,1620,1200,6,1958,850000
6762813241,3090,10,3090,0,4,1998,780000
6762813406,2210,8,1560,650,2,1951,767500
6762813820,4660,9,2600,2060,5,1979,739000
6762814022,2410,9,1930,480,2,2007,725000
6762814063,2680,8,1540,1140,3,1963,721000
6762814288,2510,8,2510,0,4,2011,706000
6762814441,2810,9,2810,0,4,2002,699900
6762815014,1180,10,780,400,2,2014,664950
6762815213,1500,7,1420,80,4,1929,651500
6762815415,2070,8,1360,710,4,1974,645000
6762815529,2080,7,1370,710,3,1960,638700
6762815594,1920,8,1200,720,4,1969,635000
6762815595,2930,8,2930,0,4,2014,635000
6762815596,1940,7,1480,460,3,1955,635000
6762815810,2180,8,1240,940,3,1977,625000
6762816628,2210,8,2210,0,4,1901,589000
6762816975,1310,6,1310,0,1,1918,575000
6762817227,2290,9,1670,620,3,1979,565000
6762817367,1790,8,1240,550,4,1983,560000
6762817426,2390,8,2390,0,4,2001,557500
6762818041,2070,8,1220,850,3,1982,539000
6762818488,2100,10,1320,780,3,1979,525000
6762819008,1820,8,1820,0,3,1988,505000
6762819165,2040,7,1020,1020,4,1943,500000
6762819254,2430,8,1630,800,3,1977,499900
6762819520,2242,8,2242,0,4,1995,490000
6762820002,2680,7,2680,0,4,1999,475000
6762820104,2010,8,2010,0,3,1998,471000
6762820319,2820,9,2820,0,4,1989,465000
6762820709,1880,8,1880,0,4,1952,453000
6762821558,1750,7,1210,540,3,1987,434000
6762821584,2390,8,1600,790,3,1978,432500
6762821694,2010,8,2010,0,4,1962,430000
6762821736,1490,8,1490,0,3,2014,429900
6762821925,1680,8,1680,0,3,1985,425000
6762822028,910,7,910,0,2,1923,422500
6762822606,1370,7,1370,0,3,1962,406000
6762822676,2260,7,1280,980,3,1910,405000
6762823198,1020,6,1020,0,2,1923,393000
6762823676,700,6,700,0,2,1926,380000
6762823921,1380,7,1380,0,3,1986,375000
6762823922,1530,8,1530,0,3,2009,375000
6762824105,2200,7,1120,1080,4,1951,370000
6762824747,1710,7,1320,390,4,1956,353750
6762825191,1920,8,1920,0,3,1984,345000
6762826158,2010,8,2010,0,4,1988,324900
6762826535,1370,8,1370,0,3,2009,315000
6762826738,920,6,920,0,1,1944,310000
6762826941,1610,7,1610,0,2,1979,305000
6762827009,1400,7,1400,0,2,1999,303000
6762827494,1650,7,1650,0,3,1958,292000
6762827832,1590,7,1090,500,3,1969,284850
6762828663,960,5,960,0,3,1922,265000
6762828958,1500,7,1000,500,3,1945,257100
6762829275,1660,7,1350,310,3,1910,250000
6762829844,1370,8,1370,0,3,1977,235000
6762830404,1010,6,1010,0,3,1925,216000
6762831460,1070,7,1070,0,3,1960,147000
6762810493,2190,9,2190,0,3,1957,1570000
6762810857,5844,11,5844,0,4,2007,1280000
6762810912,4120,8,2060,2060,4,1947,1250000
6762812221,2870,9,2870,0,3,2014,880000
6762812677,2530,6,2530,0,6,1978,830000
6762812738,3200,9,2390,810,4,2006,825000
6762812789,3720,10,3720,0,4,1999,820000
6762812999,4600,10,2400,2200,4,1989,800000
6762813000,3370,9,3370,0,4,2005,800000
6762813794,3060,9,3060,0,4,2007,740000
6762813929,3440,10,3440,0,4,2014,730000
6762814339,2560,9,2560,0,3,1981,700500
6762814652,2510,8,2510,0,4,2007,685000
6762814913,2370,8,1660,710,4,1976,670000
6762815363,2730,9,2730,0,4,2008,649000
6762815442,2520,8,2520,0,4,2014,642860
6762815640,2560,7,1370,1190,6,1961,632000
6762815684,2900,7,1990,910,4,1947,630000
6762816432,1090,6,1090,0,1,1958,598800
6762816582,2400,9,2400,0,3,1996,590000
6762816879,1490,7,1490,0,3,1916,578500
6762817091,2380,8,2380,0,4,1977,570000
6762817667,1740,8,1280,460,2,1950,550000
6762819009,2300,8,1520,780,3,1977,505000
6762819166,1560,8,1560,0,3,2014,500000
6762819167,2230,8,2230,0,4,2002,500000
6762819388,1930,8,1130,800,4,1959,495000
6762819521,1890,8,1890,0,3,1986,490000
6762819806,1740,7,1290,450,3,1939,480000
6762820320,900,6,900,0,3,1941,465000
6762821107,2160,7,1220,940,4,1976,445000
6762821281,2798,9,2798,0,4,2011,440000
6762821511,2160,7,1410,750,4,1978,435000
6762821695,1320,7,1320,0,2,2001,430000
6762821926,830,6,830,0,2,1925,425000
6762822337,2230,8,1180,1050,4,1955,415000
6762822617,2390,7,1610,780,3,1983,405300
6762823397,1890,7,1890,0,4,2006,388500
6762824293,2470,8,2470,0,3,1990,365000
6762824627,1960,7,1220,740,4,1955,355950
6762824791,2100,8,2100,0,4,1967,352500
6762825376,1870,7,1120,750,3,1913,340000
6762825526,1830,7,1830,0,3,1994,336500
6762825820,910,6,910,0,3,1969,330000
6762826071,1160,7,1160,0,3,1966,325000
6762826881,1240,7,1240,0,3,1950,305500
6762826942,1290,7,1290,0,2,2008,305000
6762827152,1220,7,1220,0,2,1963,300000
6762827243,1190,7,1190,0,3,1981,299500
6762827517,1590,6,1140,450,4,1942,291000
6762827588,1700,8,1700,0,2,1972,290000
6762827708,2300,8,1550,750,3,1978,287000
6762828071,1980,7,1980,0,4,1969,279000
6762828234,900,6,900,0,2,1938,275000
6762828369,1710,7,910,800,4,1975,271000
6762828435,1010,7,1010,0,3,1974,270000
6762829055,1180,7,1180,0,3,1967,255000
6762829555,1500,8,1500,0,3,1976,244000
6762829782,1300,7,1300,0,3,1967,236000
6762829845,1660,7,1660,0,2,1995,235000
6762830072,1570,7,1570,0,4,1943,228900
6762830295,1900,7,1260,640,3,1959,220000
6762830453,1980,7,1980,0,5,1962,215000
6762830773,1360,7,1360,0,4,1962,201000
6762810437,3490,9,2570,920,3,2009,1620000
6762810745,2300,7,2300,0,4,1934,1340000
6762811404,2830,9,2830,0,4,2014,1040000
6762811738,2760,9,2120,640,3,2004,952000
6762811777,3800,10,3800,0,4,1986,950000
6762812132,3480,10,3480,0,4,1989,895000
6762812739,4080,8,2720,1360,5,1961,825000
6762812740,2180,8,2180,0,4,1920,825000
6762812741,2670,9,1870,800,3,2014,825000
6762813184,2840,9,2840,0,4,2014,784950
6762813865,3270,9,3270,0,4,1993,735000
6762814776,2820,9,2820,0,4,2004,677000
6762815306,1940,7,1940,0,3,1957,650000
6762815685,3020,7,3020,0,5,1901,630000
6762815851,1550,7,860,690,4,1918,623500
6762815916,2730,8,2730,0,4,2008,620000
6762816761,1990,7,1170,820,2,1948,582500
6762816767,1210,7,910,300,2,1942,582000
6762816831,1820,7,1820,0,3,1999,580000
6762817026,2290,9,2290,0,3,1979,572500
6762817092,1100,7,1100,0,2,1906,570000
6762817228,4040,9,2900,1140,3,2006,565000
6762817430,2660,8,2660,0,4,1983,557000
6762818625,2080,7,1280,800,3,1950,520000
6762819025,2490,8,2490,0,3,1993,504750
6762819807,2980,8,2980,0,3,2006,480000
6762820259,2670,9,2670,0,3,2007,465750
6762820321,1600,8,1600,0,3,2005,465000
6762820389,1900,7,1300,600,4,1961,463000
6762822112,1800,7,1300,500,3,1959,420000
6762822113,1790,8,1520,270,3,1937,420000
6762822677,1160,6,870,290,2,1937,405000
6762822678,1440,7,1440,0,3,1965,405000
6762823312,1600,7,1600,0,3,1954,390000
6762824341,1650,7,860,790,2,1978,364000
6762824466,2350,7,1320,1030,3,1966,360000
6762824587,1630,7,1630,0,3,1983,357500
6762824937,1480,7,1480,0,3,1957,350000
6762825034,2530,7,2530,0,5,2004,349900
6762825062,1550,8,1550,0,2,2007,348500
6762825415,2360,8,2360,0,3,1995,339999
6762825488,2400,7,1200,1200,3,1961,338000
6762825914,2650,9,2650,0,4,2005,329000
6762825964,1810,8,1310,500,3,1984,327000
6762826072,1570,7,1570,0,3,1967,325000
6762826385,750,7,750,0,2,1949,319000
6762826536,2240,8,2240,0,3,2002,315000
6762826537,1950,7,1950,0,3,2001,315000
6762827010,1000,7,840,160,2,2007,303000
6762827227,1580,7,1580,0,4,2011,299900
6762827676,1410,7,1410,0,3,1961,288000
6762828072,1660,7,1660,0,3,2003,279000
6762828148,870,7,870,0,3,1953,276000
6762828235,1950,7,1130,820,5,1964,275000
6762828236,520,5,520,0,1,1930,275000
6762828852,1360,7,1360,0,4,1966,260000
6762828927,1800,7,1800,0,3,1983,258500
6762829056,740,6,740,0,2,1926,255000
6762829366,1850,7,1500,350,3,1979,249000
6762829509,1422,7,1422,0,3,2012,245000
6762829556,1180,7,1180,0,2,1955,244000
6762830037,1570,6,1570,0,4,1911,229950
6762830061,1010,7,1010,0,3,1959,229000
6762830490,1680,7,1680,0,4,2001,213400
6762830580,1830,7,1230,600,3,1953,210000
6762830810,1090,6,1090,0,3,1963,200000
6762831202,800,5,800,0,2,1933,175000
6762810084,5780,11,4130,1650,4,2008,2890000
6762810318,3930,12,3930,0,4,1999,1800000
6762810777,2040,10,2040,0,3,1980,1320000
6762811369,2090,8,1530,560,3,1931,1050000
6762812912,3460,7,2860,600,8,1987,808000
6762813384,2070,8,2070,0,3,1996,770000
6762813440,3230,9,3230,0,4,2004,765000
6762813648,3140,9,3140,0,4,1979,750000
6762814835,2940,9,2940,0,4,1986,675000
6762815219,1890,7,1890,0,3,1919,651000
6762815628,3630,11,3630,0,5,2000,633000
6762817170,2070,8,2070,0,3,1986,567000
6762817482,2080,7,1040,1040,3,1951,555000
6762818020,1670,8,1670,0,3,2014,539950
6762818066,2250,8,2250,0,3,1988,538000
6762819389,1460,8,1260,200,2,2005,495000
6762819666,1400,7,1100,300,4,1900,485000
6762820878,1150,7,1010,140,3,1950,450000
6762821696,630,7,630,0,1,1943,430000
6762823074,1360,7,1360,0,3,1989,396900
6762823148,1200,6,600,600,2,1949,395000
6762823440,1270,7,1270,0,3,1972,386100
6762823923,1670,7,1130,540,3,1974,375000
6762823924,980,7,980,0,2,1919,375000
6762825305,1510,8,1510,0,3,1960,340768
6762825307,1770,7,1770,0,3,1957,340500
6762825377,1880,7,940,940,2,1951,340000
6762825915,1840,8,1840,0,3,1989,329000
6762826386,1640,7,1060,580,3,1967,319000
6762826668,1190,6,1190,0,3,1918,311000
6762826800,1820,7,1040,780,3,1961,309000
6762826984,2030,8,2030,0,4,2001,304500
6762827244,1820,7,1820,0,3,1994,299500
6762827329,1580,7,1580,0,3,1961,296500
6762827983,980,6,830,150,3,1948,280000
6762828480,1400,7,1400,0,3,1989,269950
6762828528,1290,8,660,630,2,1969,268500
6762829510,1930,8,1280,650,4,1981,245000
6762829610,1010,6,1010,0,3,1973,241000
6762829715,1480,7,1120,360,4,1959,239900
6762830062,1020,7,1020,0,3,1954,229000
6762831156,1180,7,1180,0,3,1952,179500
6762810778,2120,8,1830,290,4,1908,1320000
6762822114,2720,8,2720,0,3,2002,420000
6762827802,1210,6,710,500,2,1951,285000
6762828853,2240,7,1140,1100,4,1967,260000
6762829057,1360,6,680,680,2,1924,255000
6762829392,2320,8,1160,1160,4,1966,248000
6762830063,1820,7,1820,0,4,1920,229000
6762831510,1430,6,1430,0,5,1947,133000
6762811370,2790,8,1880,910,4,1905,1050000
6762818700,1140,7,1140,0,2,1925,517000
6762810283,4110,9,3150,960,5,1921,1880000
6762811638,1660,8,1660,0,3,2008,975000
6762812885,4140,9,4140,0,4,2007,810000
6762813127,2390,9,1790,600,3,1929,790000
6762813649,3430,11,3430,0,4,1995,750000
6762813741,2810,9,2810,0,3,1995,745000
6762814056,3700,8,1850,1850,5,1970,722500
6762814309,1460,7,1460,0,3,1912,705000
6762814914,1710,7,1410,300,3,1946,670000
6762815307,1380,7,1080,300,3,1955,650000
6762815308,2400,8,1900,500,5,1911,650000
6762815542,2320,8,2160,160,4,1999,637500
6762815629,4220,9,2910,1310,4,2006,633000
6762815733,2750,9,2750,0,4,2014,627000
6762815811,2660,8,2180,480,4,1977,625000
6762816115,3610,8,3210,400,6,1970,610000
6762816342,2300,8,2300,0,3,1955,600000
6762816709,3180,7,1690,1490,5,1968,585000
6762816976,2150,8,1080,1070,3,1951,575000
6762817093,1370,7,1370,0,3,1927,570000
6762817094,3250,8,3250,0,4,2011,570000
6762817668,1540,7,1540,0,4,1913,550000
6762817669,2780,8,2780,0,5,2014,550000
6762818489,2040,7,2040,0,3,1983,525000
6762818626,2310,8,1580,730,3,1983,520000
6762818627,1810,8,1810,0,3,1954,520000
6762819168,1680,7,1680,0,4,1900,500000
6762819282,1720,8,1000,720,3,1977,499000
6762820322,2550,7,2550,0,5,2008,465000
6762820404,1860,8,1860,0,2,1986,462370
6762821435,1150,8,1020,130,3,2006,436000
6762822430,2190,7,1340,850,4,1969,411800
6762822894,1300,7,1300,0,3,1943,400000
6762823761,2410,8,2410,0,4,2001,379000
6762824467,1900,7,1900,0,4,1992,360000
6762824468,1255,8,1255,0,3,2010,360000
6762824938,1010,7,1010,0,3,1961,350000
6762824939,1760,7,1760,0,3,1995,350000
6762825238,2400,8,2400,0,4,2004,344000
6762825378,2180,9,1630,550,4,1975,340000
6762825497,1300,7,1300,0,2,1950,337500
6762825616,1990,7,1340,650,3,1977,335000
6762825710,1440,7,1440,0,4,1972,332500
6762825725,2420,8,1500,920,5,1962,332000
6762825940,1930,7,1170,760,4,1997,328000
6762826073,1150,7,1150,0,2,2013,325000
6762826179,1550,7,1550,0,3,2001,324000
6762826190,1440,7,1440,0,4,1963,323000
6762826414,1220,6,1220,0,2,1948,317500
6762826739,1150,7,1150,0,3,1988,310000
6762827628,1870,7,1870,0,3,2004,289950
6762827803,2150,7,1240,910,4,1978,285000
6762828101,1590,7,1170,420,3,1985,278000
6762828297,1700,7,950,750,2,1980,274000
6762828298,1830,8,1830,0,3,2005,274000
6762828436,1370,6,1370,0,3,1945,270000
6762828596,1550,8,1550,0,3,1989,266000
6762828771,2460,8,1500,960,4,1977,261500
6762828854,1950,7,1200,750,3,1987,260000
6762829276,1710,7,1010,700,4,1968,250000
6762829557,1360,7,1360,0,3,1983,244000
6762829733,1500,7,1000,500,4,1977,239000
6762829924,1390,7,1390,0,3,1963,232000
6762830258,980,7,980,0,3,1954,221000
6762830581,1050,6,1050,0,1,1947,210000
6762830753,1540,6,1540,0,3,1954,202500
6762830811,920,6,920,0,2,1906,200000
6762810188,3790,10,2530,1260,4,1931,2200000
6762810359,3070,10,2670,400,4,1927,1720000
6762810869,3020,8,1920,1100,4,1927,1270000
6762811170,3180,9,2070,1110,4,1925,1130000
6762811405,4920,10,3820,1100,4,2006,1040000
6762812176,4230,9,3780,450,3,1951,887500
6762813509,3580,9,3580,0,4,2004,760000
6762813545,3210,7,2040,1170,4,1914,756450
6762814310,2910,8,2350,560,4,1976,705000
6762814386,1580,8,1290,290,3,1939,700000
6762815042,2600,8,2150,450,4,2011,661000
6762815812,3010,9,2570,440,4,2012,625000
6762816425,1840,10,1700,140,3,2013,599000
6762816977,2010,7,2010,0,3,1922,575000
6762817229,1370,7,1370,0,1,1921,565000
6762817988,2870,7,2330,540,6,1960,540000
6762818030,2710,8,2040,670,4,1997,539500
6762818561,2660,8,2660,0,4,1988,523000
6762818628,1960,7,1320,640,4,1923,520000
6762818768,1490,7,1490,0,3,1956,515000
6762818769,1880,6,1880,0,5,1922,515000
6762818889,1310,6,1310,0,2,1913,510000
6762819522,3630,10,3630,0,4,1997,490000
6762820088,2200,8,1200,1000,3,1961,472000
6762820879,2820,9,1820,1000,4,1972,450000
6762821108,2790,10,2790,0,3,1988,445000
6762821282,1640,7,1640,0,3,1951,440000
6762821512,2940,9,2940,0,4,1991,435000
6762821601,2410,8,1410,1000,3,1981,432000
6762822338,760,7,760,0,2,1944,415000
6762822679,1660,7,830,830,3,1981,405000
6762822680,1280,7,1280,0,3,1960,405000
6762823149,1980,7,1980,0,4,1977,395000
6762823150,2280,8,2280,0,4,2009,395000
6762823313,2092,7,2092,0,3,1981,390000
6762823573,1720,8,1720,0,3,1993,383000
6762823574,1400,7,1400,0,3,1910,383000
6762823677,3450,9,3450,0,5,2004,380000
6762823762,2660,8,2660,0,3,2014,379000
6762824696,1860,8,1860,0,3,2012,355000
6762825128,2160,8,2160,0,4,1999,345500
6762825653,2190,8,2190,0,4,1997,334950
6762825821,2380,8,2380,0,4,1984,330000
6762826074,1920,7,1920,0,4,1967,325000
6762826075,1440,7,1440,0,3,1995,325000
6762826645,1160,7,1160,0,2,1916,312000
6762827020,2200,8,2200,0,3,1994,302495
6762827473,1860,8,1860,0,4,1994,292500
6762827804,1960,8,1220,740,4,1985,285000
6762828149,1820,7,1200,620,3,1958,276000
6762828237,1290,7,1290,0,3,1956,275000
6762828373,2406,8,2406,0,5,2006,270500
6762828511,1950,8,1950,0,3,1966,269000
6762828743,1584,7,1584,0,3,2011,263000
6762829159,2050,7,1520,530,3,1987,252000
6762829277,1072,7,1072,0,3,2009,250000
6762829846,1240,7,1240,0,3,1943,235000
6762830177,1010,6,1010,0,3,1961,225000
6762830325,1200,7,1200,0,3,1964,219950
6762830454,1060,7,1060,0,3,1960,215000
6762830673,920,7,920,0,3,1963,206000
6762830834,960,5,960,0,3,1900,199999
6762810691,4350,11,4350,0,5,2014,1380000
6762811498,3100,7,2040,1060,4,1939,1000000
6762814174,2970,9,2970,0,4,2005,715000
6762814387,2090,7,1290,800,3,1922,700000
6762815309,3990,9,2820,1170,5,1990,650000
6762818031,2280,8,1660,620,4,1977,539500
6762818161,2730,9,2730,0,2,1998,535000
6762819169,1440,7,1210,230,2,1948,500000
6762819808,1540,7,1540,0,3,1977,480000
6762819809,1140,6,1140,0,2,1943,480000
6762821352,2690,9,2690,0,4,1992,439000
6762821554,1960,7,1960,0,5,1968,434400
6762822024,1820,7,1340,480,3,1976,422800
6762822339,1510,7,1090,420,2,1939,415000
6762822511,1340,7,1340,0,3,1961,410000
6762824106,940,6,940,0,3,1959,370000
6762824354,1750,8,1750,0,3,1993,363000
6762824469,2390,9,2390,0,4,1990,360000
6762825192,2020,7,2020,0,3,1979,345000
6762825916,1120,7,1120,0,4,1972,329000
6762826076,960,6,960,0,2,1912,325000
6762826309,1270,7,1270,0,3,1956,320000
6762826387,1610,7,1610,0,3,1994,319000
6762826740,1400,7,900,500,2,1922,310000
6762827984,1960,7,980,980,2,1957,280000
6762828664,1510,7,1150,360,3,1985,265000
6762829058,1110,7,1110,0,3,1964,255000
6762829059,1580,7,1100,480,3,1962,255000
6762829427,1610,7,1610,0,3,1967,246700
6762831353,1040,6,850,190,2,1950,160000
6762831380,1170,7,1170,0,3,1960,157000
6762811152,4590,10,3160,1430,4,2003,1140000
6762811952,3300,8,2200,1100,6,1970,920000
6762812282,2860,7,1560,1300,4,1946,874000
6762812330,4890,9,3590,1300,5,2014,865950
6762812386,3830,10,3830,0,4,2001,860000
6762813081,2920,10,2920,0,4,1978,795000
6762816209,2260,9,2260,0,4,1976,605000
6762816978,1430,7,1430,0,4,1910,575000
6762818162,2110,9,2110,0,3,1990,535000
6762818490,1620,7,1200,420,3,1969,525000
6762818549,1980,7,1260,720,4,1973,524000
6762819170,2330,7,1230,1100,4,1961,500000
6762819667,1670,7,1670,0,3,1925,485000
6762820003,1330,7,1330,0,3,1983,475000
6762820069,1050,7,1050,0,3,1985,473000
6762820649,1980,7,1980,0,3,1993,455000
6762820969,2490,7,2490,0,4,2007,449400
6762822340,3700,8,1850,1850,5,1957,415000
6762823010,1620,6,1620,0,3,1918,399000
6762823608,1320,7,1320,0,2,1908,381156
6762823822,2301,9,2301,0,4,2010,375500
6762823925,2750,9,2750,0,3,1989,375000
6762824107,2650,9,2650,0,4,2005,370000
6762824752,1260,8,840,420,3,2008,353500
6762824940,1470,6,1470,0,3,1949,350000
6762825617,1420,7,1420,0,2,2004,335000
6762828238,1340,7,1340,0,3,1944,275000
6762829060,1360,8,1360,0,2,1974,255000
6762829061,1987,7,1987,0,4,2011,255000
6762829278,2590,7,1340,1250,6,1970,250000
6762829279,1780,8,1420,360,3,1979,250000
6762829405,2460,7,1230,1230,4,1948,247500
6762829604,1350,7,1350,0,3,1993,241250
6762830455,1900,7,1900,0,4,1967,215000
6762830849,1010,6,1010,0,2,1961,199950
6762831336,1190,7,1190,0,3,1968,160134
6762831410,1730,6,1730,0,4,1970,152500
6762831542,1150,7,1150,0,3,1956,123300
6762820004,2400,7,1600,800,4,1965,475000
6762824941,1860,8,1860,0,3,1992,350000
6762810118,5620,11,4140,1480,5,1916,2500000
6762810620,2840,9,2440,400,5,1905,1430000
6762811132,1940,9,1940,0,4,1925,1150000
6762811201,3300,10,3300,0,5,2007,1110000
6762811406,3170,10,3170,0,4,1988,1040000
6762811953,3550,9,3550,0,4,1996,920000
6762813001,3120,9,3120,0,4,2010,800000
6762813128,2460,7,1410,1050,4,1961,790000
6762813176,1950,9,1610,340,3,2009,785000
6762813832,2620,9,2620,0,3,1995,738000
6762814190,3230,9,3230,0,4,2005,714000
6762814388,2830,8,1610,1220,5,1979,700000
6762814722,3180,8,1590,1590,6,1967,680000
6762815079,2920,7,1860,1060,10,1913,660000
6762815112,1180,10,780,400,2,2014,659000
6762815917,3880,10,3060,820,4,2007,620000
6762816045,3150,8,1870,1280,5,1907,614000
6762816900,2560,8,2560,0,3,2001,577000
6762816979,1590,7,1110,480,3,1984,575000
6762817295,2560,8,1860,700,4,1980,562000
6762817408,2250,8,1450,800,4,1954,559000
6762817483,2810,8,1440,1370,5,1964,555000
6762817670,950,7,950,0,2,1924,550000
6762817989,3100,7,1820,1280,3,1981,540000
6762818297,3020,7,1860,1160,5,1925,530000
6762818770,1690,7,1690,0,3,1907,515000
6762818771,2220,7,1390,830,5,1925,515000
6762819171,2210,8,2210,0,3,1978,500000
6762819390,2430,9,1530,900,3,1988,495000
6762819391,1580,8,1580,0,3,2014,495000
6762819668,3270,9,3270,0,5,2004,485000
6762820089,2770,9,2770,0,3,2004,472000
6762820525,2060,7,1190,870,4,1975,459500
6762821109,1260,7,1260,0,3,1949,445000
6762821368,3050,9,3050,0,3,1988,438500
6762822115,1890,7,1890,0,5,1962,420000
6762822341,1130,8,1130,0,2,2010,415000
6762822963,1040,7,1040,0,3,1978,399950
6762823797,2640,8,2640,0,4,1999,377500
6762823815,1540,8,1540,0,3,2005,376000
6762824360,2140,7,1140,1000,4,1960,362950
6762824470,2490,7,2490,0,4,2001,360000
6762825193,1320,8,1320,0,3,2010,345000
6762825304,920,7,920,0,2,1947,340895
6762825518,1690,8,1410,280,3,2014,336900
6762826310,2320,7,1160,1160,3,1960,320000
6762826538,1900,8,1900,0,3,1995,315000
6762826846,2520,7,1260,1260,4,1987,307000
6762826943,1646,7,1646,0,3,1996,305000
6762827021,3130,8,1580,1550,5,1973,302300
6762828239,1540,7,1540,0,3,1967,275000
6762828370,710,6,710,0,2,1942,271000
6762828761,1320,7,1320,0,3,1989,262000
6762829062,1320,7,1040,280,3,2007,255000
6762829280,1520,7,1120,400,3,1967,250000
6762829716,1000,6,1000,0,4,1943,239900
6762829747,1360,7,1050,310,3,1975,238000
6762830003,720,6,720,0,2,1920,230000
6762830296,1230,7,1230,0,3,1969,220000
6762830657,1068,7,1068,0,2,1990,207000
6762830761,840,5,840,0,2,1907,202000
6762830812,2120,7,1220,900,3,1942,200000
6762830931,1430,7,1030,400,3,1977,195000
6762831077,1130,7,1130,0,3,1978,185000
6762810050,4220,11,2460,1760,3,1958,3300000
6762810244,4690,11,3480,1210,4,2001,1950000
6762810377,4930,11,4160,770,5,2000,1700000
6762810517,2850,10,1820,1030,4,1908,1540000
6762810886,4180,10,4180,0,5,2014,1260000
6762811024,2480,7,2480,0,3,1955,1200000
6762811327,2700,10,2700,0,3,1977,1060000
6762812742,3220,9,3220,0,4,2003,825000
6762813358,2420,9,2420,0,4,1991,771000
6762813821,2750,9,2560,190,3,1981,739000
6762814653,1460,7,1460,0,3,1956,685000
6762815502,2360,8,2360,0,4,1904,640000
6762815686,2470,8,2470,0,6,1982,630000
6762815877,1950,7,1250,700,4,1960,621000
6762815918,3040,7,3040,0,4,2003,620000
6762816132,1910,9,1910,0,2,2002,609850
6762817671,2430,8,2430,0,3,2007,550000
6762818055,1780,8,1780,0,4,1964,538200
6762818298,920,6,920,0,3,1950,530000
6762818362,1910,8,1280,630,4,1960,528000
6762819392,2100,7,2100,0,3,1996,495000
6762820202,1480,8,1000,480,3,2014,469000
6762820483,1290,7,1290,0,3,1962,460000
6762820650,2380,6,1470,910,4,1926,455000
6762821988,2090,7,2090,0,3,1967,424950
6762822116,2110,8,2110,0,4,2000,420000
6762822342,1980,7,1980,0,3,2003,415000
6762824697,2230,7,1220,1010,4,1954,355000
6762824942,1490,7,1490,0,3,1985,350000
6762824943,1920,7,1320,600,3,1959,350000
6762825379,1570,8,1570,0,3,2001,340000
6762826944,1800,7,1800,0,4,1974,305000
6762828855,2580,7,1410,1170,5,1964,260000
6762829281,720,6,720,0,1,1935,250000
6762829847,830,6,830,0,2,1939,235000
6762830004,1810,5,1050,760,6,1905,230000
6762830105,1560,7,1560,0,3,1968,226500
6762830626,1570,7,1570,0,2,2007,208400
6762831000,1640,6,1040,600,3,1939,190000
6762831001,760,6,760,0,3,1906,190000
6762831028,1460,7,1170,290,3,1995,189000
6762831354,1540,6,770,770,4,1969,160000
6762831441,870,6,870,0,2,1957,150000
6762810958,2600,9,2200,400,4,1939,1230000
6762811865,2460,8,1560,900,3,1929,931000
6762812040,3520,9,3520,0,3,2004,905000
6762812266,1160,7,1160,0,3,1953,875000
6762812706,1890,9,1890,0,3,1929,826000
6762812743,3210,10,3210,0,4,1993,825000
6762813082,2260,8,1880,380,3,2003,795000
6762813562,3450,11,2690,760,3,1989,755000
6762814575,1890,8,1890,0,3,1954,690000
6762814596,3250,9,3250,0,4,2014,689000
6762815000,2510,9,2510,0,4,1998,665000
6762816042,2730,8,2730,0,5,2015,614285
6762816137,2470,8,2470,0,6,1982,609000
6762816210,2570,9,2570,0,3,1989,605000
6762816343,1410,7,1000,410,3,1950,600000
6762816768,1820,8,1820,0,3,1949,582000
6762816871,2300,8,1800,500,3,1961,579000
6762816980,2280,8,2280,0,4,1996,575000
6762817230,2130,8,1240,890,5,1959,565000
6762818680,1780,7,1050,730,4,1951,518000
6762818937,1630,6,1030,600,4,1915,509000
6762819669,2100,7,2100,0,4,1964,485000
6762820484,2720,8,2720,0,3,2001,460000
6762820982,1660,7,1660,0,3,1952,449000
6762821149,1780,8,1530,250,3,2007,443000
6762821195,1100,7,1100,0,4,1919,441000
6762821927,1400,8,1400,0,3,1984,425000
6762822600,1840,8,1340,500,3,1989,406500
6762823071,1100,7,1100,0,3,1969,397000
6762824294,1520,7,1520,0,3,1954,365000
6762825684,1220,7,1220,0,3,1965,333500
6762825822,1990,7,1990,0,3,1996,330000
6762825951,1820,8,1570,250,3,2008,327500
6762826539,1580,7,1080,500,4,2002,315000
6762826741,1310,7,1310,0,3,2003,310000
6762828349,1810,7,1200,610,4,1980,272000
6762828783,1350,7,1350,0,3,1987,261000
6762828856,1180,6,1180,0,3,1959,260000
6762829600,1400,7,1400,0,3,1968,241500
6762829669,1590,7,1190,400,3,1979,240000
6762830250,1556,7,1556,0,2,1957,221700
6762830339,1680,7,1680,0,3,1968,219200
6762830618,1070,6,1070,0,2,1962,209000
6762830709,1030,6,1030,0,4,1955,205000
6762831463,900,6,900,0,3,1969,146000
